TATCCGCCCTCACGCTACT->ATCCGCCCTCACGCTACTG
ATCCGCCCTCACGCTACTG->TCCGCCCTCACGCTACTGA
GTACATCAATGGAATATGC->TACATCAATGGAATATGCC
TACATCAATGGAATATGCC->ACATCAATGGAATATGCCT
CTGCAAAGACCACGGAAGC->TGCAAAGACCACGGAAGCC
TGCAAAGACCACGGAAGCC->GCAAAGACCACGGAAGCCT
GGAAGATGTCACGATTCTT->GAAGATGTCACGATTCTTA
GAAGATGTCACGATTCTTA->AAGATGTCACGATTCTTAC
GGATATTCGTAAGCCGCCA->GATATTCGTAAGCCGCCAT
GATATTCGTAAGCCGCCAT->ATATTCGTAAGCCGCCATG
TAGAGGCCCGCGGTTGAGT->AGAGGCCCGCGGTTGAGTA
AGAGGCCCGCGGTTGAGTA->GAGGCCCGCGGTTGAGTAA
TGACTCTTGGTTAGTTTTT->GACTCTTGGTTAGTTTTTC
GACTCTTGGTTAGTTTTTC->ACTCTTGGTTAGTTTTTCA
GAAGCGAATTATAGTAGAG->AAGCGAATTATAGTAGAGG
AAGCGAATTATAGTAGAGG->AGCGAATTATAGTAGAGGC
TCAACGTGATTGGTACTAT->CAACGTGATTGGTACTATA
CAACGTGATTGGTACTATA->AACGTGATTGGTACTATAT
CGTGATTGGTACTATATGC->GTGATTGGTACTATATGCA
GTGATTGGTACTATATGCA->TGATTGGTACTATATGCAG
CCAGGAGAGGCTCGCGCCT->CAGGAGAGGCTCGCGCCTC
CAGGAGAGGCTCGCGCCTC->AGGAGAGGCTCGCGCCTCT
GACCCTCCGAACCGCCCCA->ACCCTCCGAACCGCCCCAA
ACCCTCCGAACCGCCCCAA->CCCTCCGAACCGCCCCAAA
TAACTATCAAAAGTTGCTC->AACTATCAAAAGTTGCTCA
AACTATCAAAAGTTGCTCA->ACTATCAAAAGTTGCTCAA
GGTACCTTCCATAACGAAC->GTACCTTCCATAACGAACG
GTACCTTCCATAACGAACG->TACCTTCCATAACGAACGC
CTCCATCCCGATGTATTCA->TCCATCCCGATGTATTCAG
TCCATCCCGATGTATTCAG->CCATCCCGATGTATTCAGG
GAGGTACCGATACGTGCTG->AGGTACCGATACGTGCTGA
AGGTACCGATACGTGCTGA->GGTACCGATACGTGCTGAA
GGGTCAGTTCGGCCTTTTG->GGTCAGTTCGGCCTTTTGA
GGTCAGTTCGGCCTTTTGA->GTCAGTTCGGCCTTTTGAA
TTTTATCTGGACGCTTAAC->TTTATCTGGACGCTTAACA
TTTATCTGGACGCTTAACA->TTATCTGGACGCTTAACAT
CTCCCCGTCTCCGCTCCAG->TCCCCGTCTCCGCTCCAGC
TCCCCGTCTCCGCTCCAGC->CCCCGTCTCCGCTCCAGCG
ACTGAGAAAAGCCGTTCAA->CTGAGAAAAGCCGTTCAAA
CTGAGAAAAGCCGTTCAAA->TGAGAAAAGCCGTTCAAAA
TACAATGTCTCGCTCTAGA->ACAATGTCTCGCTCTAGAC
ACAATGTCTCGCTCTAGAC->CAATGTCTCGCTCTAGACC
TTCTGTCAGCCGAGAGGCC->TCTGTCAGCCGAGAGGCCC
TCTGTCAGCCGAGAGGCCC->CTGTCAGCCGAGAGGCCCT
GATCCTGTGGCCCTAGCTC->ATCCTGTGGCCCTAGCTCA
ATCCTGTGGCCCTAGCTCA->TCCTGTGGCCCTAGCTCAC
AAAATACCGGGAATGCCGG->AAATACCGGGAATGCCGGT
AAATACCGGGAATGCCGGT->AATACCGGGAATGCCGGTT
TGTCCCACATCTAGACCCC->GTCCCACATCTAGACCCCT
GTCCCACATCTAGACCCCT->TCCCACATCTAGACCCCTA
CGGGACGCGTTATACCTAT->GGGACGCGTTATACCTATT
GGGACGCGTTATACCTATT->GGACGCGTTATACCTATTC
AGGGATGACCACGCTTTAG->GGGATGACCACGCTTTAGT
GGGATGACCACGCTTTAGT->GGATGACCACGCTTTAGTA
TTTATTCTTGACACCTTAT->TTATTCTTGACACCTTATA
TTATTCTTGACACCTTATA->TATTCTTGACACCTTATAC
ATTCAGGACCCTCCGAATT->TTCAGGACCCTCCGAATTT,TTCAGGACCCTCCGAATTT
TTCAGGACCCTCCGAATTT->TCAGGACCCTCCGAATTTC,TCAGGACCCTCCGAATTTC
AGTAACCCACTCAGATGGG->GTAACCCACTCAGATGGGA
GTAACCCACTCAGATGGGA->TAACCCACTCAGATGGGAT
CCAACTAACGAGACGGTTC->CAACTAACGAGACGGTTCC
CAACTAACGAGACGGTTCC->AACTAACGAGACGGTTCCG
ATTCGTTGGGAATGCAAAC->TTCGTTGGGAATGCAAACG
TTCGTTGGGAATGCAAACG->TCGTTGGGAATGCAAACGT
AGTCAAGGCTTTAACCAGT->GTCAAGGCTTTAACCAGTA
GTCAAGGCTTTAACCAGTA->TCAAGGCTTTAACCAGTAG
CGCAGATCATTCCGCTGCA->GCAGATCATTCCGCTGCAC
GCAGATCATTCCGCTGCAC->CAGATCATTCCGCTGCACA
ATGTCTCAGTATGAGGTCC->TGTCTCAGTATGAGGTCCC
TGTCTCAGTATGAGGTCCC->GTCTCAGTATGAGGTCCCC
CTGAGGAAGGGATGACCAC->TGAGGAAGGGATGACCACG
TGAGGAAGGGATGACCACG->GAGGAAGGGATGACCACGC
TCGCAGCTCTGAGGAAGGG->CGCAGCTCTGAGGAAGGGA
CGCAGCTCTGAGGAAGGGA->GCAGCTCTGAGGAAGGGAT
ATTTTATTCTTGACACCTT->TTTTATTCTTGACACCTTA
TTTTATTCTTGACACCTTA->TTTATTCTTGACACCTTAT
AGCTGTATTCAGGACCCTC->GCTGTATTCAGGACCCTCC
GCTGTATTCAGGACCCTCC->CTGTATTCAGGACCCTCCG
AGATGGGATAGCACCCTCC->GATGGGATAGCACCCTCCT
GATGGGATAGCACCCTCCT->ATGGGATAGCACCCTCCTC
TATCATCCTGATAGTCAAC->ATCATCCTGATAGTCAACC
ATCATCCTGATAGTCAACC->TCATCCTGATAGTCAACCT
AGCTCTGAGGAAGGGATGA->GCTCTGAGGAAGGGATGAC
GCTCTGAGGAAGGGATGAC->CTCTGAGGAAGGGATGACC
CTGGGTACCTTCCTCCATC->TGGGTACCTTCCTCCATCC
TGGGTACCTTCCTCCATCC->GGGTACCTTCCTCCATCCC
CAGTAAGATAAGTCAAAGC->AGTAAGATAAGTCAAAGCC
AGTAAGATAAGTCAAAGCC->GTAAGATAAGTCAAAGCCT
CATCGCGCCTTTGACGGTG->ATCGCGCCTTTGACGGTGC
ATCGCGCCTTTGACGGTGC->TCGCGCCTTTGACGGTGCT
TCAAGAGTAGTCACCGCTC->CAAGAGTAGTCACCGCTCT
CAAGAGTAGTCACCGCTCT->AAGAGTAGTCACCGCTCTC
TGATTGGTACTATATGCAG->GATTGGTACTATATGCAGG
GATTGGTACTATATGCAGG->ATTGGTACTATATGCAGGG
GTTTTACGTCAGCGACTCA->TTTTACGTCAGCGACTCAG
TTTTACGTCAGCGACTCAG->TTTACGTCAGCGACTCAGC
TGGGTACCTTCCGATACAG->GGGTACCTTCCGATACAGC
GGGTACCTTCCGATACAGC->GGTACCTTCCGATACAGCG
AGTAGTCACCGCTCTCTAG->GTAGTCACCGCTCTCTAGG
GTAGTCACCGCTCTCTAGG->TAGTCACCGCTCTCTAGGG
CCATCCCGATGTATTCAGG->CATCCCGATGTATTCAGGA
TGGAGTCAGAGGTACCGAT->GGAGTCAGAGGTACCGATA
GGAGTCAGAGGTACCGATA->GAGTCAGAGGTACCGATAC
GGTACCGATACGTGCTGAA->GTACCGATACGTGCTGAAG
GTACCGATACGTGCTGAAG->TACCGATACGTGCTGAAGA
GCACTGGAGCAGGTTAAAG->CACTGGAGCAGGTTAAAGT
CACTGGAGCAGGTTAAAGT->ACTGGAGCAGGTTAAAGTG
CAAGGCTTTAACCAGTAGA->AAGGCTTTAACCAGTAGAC
AAGGCTTTAACCAGTAGAC->AGGCTTTAACCAGTAGACA
GGGGCGAATATTTTTTATC->GGGCGAATATTTTTTATCT
GGGCGAATATTTTTTATCT->GGCGAATATTTTTTATCTG
TCAGGGATTTCTTGGGAAG->CAGGGATTTCTTGGGAAGA
CAGGGATTTCTTGGGAAGA->AGGGATTTCTTGGGAAGAT
AGCCGTTCAAAAAGTATGA->GCCGTTCAAAAAGTATGAT
GCCGTTCAAAAAGTATGAT->CCGTTCAAAAAGTATGATA
AATATGCCTCGATCAAGAC->ATATGCCTCGATCAAGACA
ATATGCCTCGATCAAGACA->TATGCCTCGATCAAGACAG
CGCAAAATACCGGGAATGC->GCAAAATACCGGGAATGCC
GCAAAATACCGGGAATGCC->CAAAATACCGGGAATGCCG
TCTGGACTCTATTGGGGCT->CTGGACTCTATTGGGGCTA
CTGGACTCTATTGGGGCTA->TGGACTCTATTGGGGCTAA
GCTTACTAACTGTCGGGAG->CTTACTAACTGTCGGGAGG
CTTACTAACTGTCGGGAGG->TTACTAACTGTCGGGAGGA
CGAATTTCAGGCCGGGACG->GAATTTCAGGCCGGGACGC
GAATTTCAGGCCGGGACGC->AATTTCAGGCCGGGACGCG
TTTTTTATCTGGACGCTTA->TTTTTATCTGGACGCTTAA
TTTTTATCTGGACGCTTAA->TTTTATCTGGACGCTTAAC
CAGTATGAGGTCCCCGCAA->AGTATGAGGTCCCCGCAAA
AGTATGAGGTCCCCGCAAA->GTATGAGGTCCCCGCAAAA
TGGTTTTACGTCAGCGACT->GGTTTTACGTCAGCGACTC
GGTTTTACGTCAGCGACTC->GTTTTACGTCAGCGACTCA
ACCGGGAATGCCGGTTTAC->CCGGGAATGCCGGTTTACC
CCGGGAATGCCGGTTTACC->CGGGAATGCCGGTTTACCT
CCCTAGCTCACACCAACTA->CCTAGCTCACACCAACTAA
CCTAGCTCACACCAACTAA->CTAGCTCACACCAACTAAC
CGGGAACTGTCAACCTAAA->GGGAACTGTCAACCTAAAT
GGGAACTGTCAACCTAAAT->GGAACTGTCAACCTAAATG
GATGCGCTTAGATGCATCA->ATGCGCTTAGATGCATCAT
ATGCGCTTAGATGCATCAT->TGCGCTTAGATGCATCATT
AAAGCCTGGGTACCTTCCA->AAGCCTGGGTACCTTCCAT
AAGCCTGGGTACCTTCCAT->AGCCTGGGTACCTTCCATA
GTATGATAGACGATACCCC->TATGATAGACGATACCCCG
TATGATAGACGATACCCCG->ATGATAGACGATACCCCGG
GGCGCAGATCATTCCGCTG->GCGCAGATCATTCCGCTGC
GCGCAGATCATTCCGCTGC->CGCAGATCATTCCGCTGCA
TACTCCTACTTGAAAGCCT->ACTCCTACTTGAAAGCCTG
ACTCCTACTTGAAAGCCTG->CTCCTACTTGAAAGCCTGG
CGTAGCACGTGGGCTTTAT->GTAGCACGTGGGCTTTATA
GTAGCACGTGGGCTTTATA->TAGCACGTGGGCTTTATAA
GGCCCGATTGCCAGGAACG->GCCCGATTGCCAGGAACGA
GCCCGATTGCCAGGAACGA->CCCGATTGCCAGGAACGAT
CAAAATACCGGGAATGCCG->AAAATACCGGGAATGCCGG
CGTATTCAGGACCCTCCGA->GTATTCAGGACCCTCCGAA,GTATTCAGGACCCTCCGAA
GTATTCAGGACCCTCCGAA->TATTCAGGACCCTCCGAAT,TATTCAGGACCCTCCGAAT,TATTCAGGACCCTCCGAAG,TATTCAGGACCCTCCGAAC
CTATATGCAGGGGCACATA->TATATGCAGGGGCACATAA
TATATGCAGGGGCACATAA->ATATGCAGGGGCACATAAT
CTCGCTCCCTCCTACTAAG->TCGCTCCCTCCTACTAAGA
TCGCTCCCTCCTACTAAGA->CGCTCCCTCCTACTAAGAC
TTCGTAAGCCGCCATGGCT->TCGTAAGCCGCCATGGCTG
TCGTAAGCCGCCATGGCTG->CGTAAGCCGCCATGGCTGC
TACCCCTTATAGCTAATGC->ACCCCTTATAGCTAATGCG
ACCCCTTATAGCTAATGCG->CCCCTTATAGCTAATGCGA
TATTCAGGACCCTCCGAAT->ATTCAGGACCCTCCGAATT,ATTCAGGACCCTCCGAATT
GCCATGGCTGCGTCAGTAA->CCATGGCTGCGTCAGTAAG
CCATGGCTGCGTCAGTAAG->CATGGCTGCGTCAGTAAGA
GACTATTCGTACGCATTAC->ACTATTCGTACGCATTACT
ACTATTCGTACGCATTACT->CTATTCGTACGCATTACTT
CAGATCATTCCGCTGCACA->AGATCATTCCGCTGCACAG
TAACCTGGCGGCTGGGATG->AACCTGGCGGCTGGGATGT
AACCTGGCGGCTGGGATGT->ACCTGGCGGCTGGGATGTT
CGTAAGCCGCCATGGCTGC->GTAAGCCGCCATGGCTGCG
TCAACCTCCACGCTGTCCC->CAACCTCCACGCTGTCCCA
CAACCTCCACGCTGTCCCA->AACCTCCACGCTGTCCCAC
CTCCTATTACAATGTCTCG->TCCTATTACAATGTCTCGC
TCCTATTACAATGTCTCGC->CCTATTACAATGTCTCGCT
AGAATTCCCGTCAAGTACT->GAATTCCCGTCAAGTACTC
GAATTCCCGTCAAGTACTC->AATTCCCGTCAAGTACTCT
AAGATGTCACGATTCTTAC->AGATGTCACGATTCTTACC
AGATGTCACGATTCTTACC->GATGTCACGATTCTTACCT
GTAATTCACGTCACCGGGG->TAATTCACGTCACCGGGGC
TAATTCACGTCACCGGGGC->AATTCACGTCACCGGGGCG
GCGCCGAGGGCGCAGTAGT->CGCCGAGGGCGCAGTAGTG
CGCCGAGGGCGCAGTAGTG->GCCGAGGGCGCAGTAGTGC
AGGAGTAAAAGCCTGGGTA->GGAGTAAAAGCCTGGGTAC
GGAGTAAAAGCCTGGGTAC->GAGTAAAAGCCTGGGTACC
CTCCGGGTAAATCCCAGGA->TCCGGGTAAATCCCAGGAG
TCCGGGTAAATCCCAGGAG->CCGGGTAAATCCCAGGAGA
CCTCCATCCCGATGTATTC->CTCCATCCCGATGTATTCA
CTGGCGGCTGGGATGTTGA->TGGCGGCTGGGATGTTGAT
TGGCGGCTGGGATGTTGAT->GGCGGCTGGGATGTTGATT
GCCCTGTAAAATCATCACT->CCCTGTAAAATCATCACTA
CCCTGTAAAATCATCACTA->CCTGTAAAATCATCACTAC
CTTAACATACATCGGATGA->TTAACATACATCGGATGAC
TTAACATACATCGGATGAC->TAACATACATCGGATGACT
CCTTCCTCCATCCCGATGT->CTTCCTCCATCCCGATGTA
CTTCCTCCATCCCGATGTA->TTCCTCCATCCCGATGTAT
AATTGTGGGAGGCGATCCT->ATTGTGGGAGGCGATCCTG
ATTGTGGGAGGCGATCCTG->TTGTGGGAGGCGATCCTGT
TTCGGCCTTTTGAACCATC->TCGGCCTTTTGAACCATCT
TCGGCCTTTTGAACCATCT->CGGCCTTTTGAACCATCTG
CTAAATGGACGATGTCGCA->TAAATGGACGATGTCGCAT
TAAATGGACGATGTCGCAT->AAATGGACGATGTCGCATC
AGCAGGTTAAAGTGGAGTC->GCAGGTTAAAGTGGAGTCA
GCAGGTTAAAGTGGAGTCA->CAGGTTAAAGTGGAGTCAG
GGTTCGCTGTTACTGATCA->GTTCGCTGTTACTGATCAG
GTTCGCTGTTACTGATCAG->TTCGCTGTTACTGATCAGT
ATTTTGGATGAAGACTGAC->TTTTGGATGAAGACTGACT
TTTTGGATGAAGACTGACT->TTTGGATGAAGACTGACTC
CCAGGAACGATGATTTTGG->CAGGAACGATGATTTTGGA
CAGGAACGATGATTTTGGA->AGGAACGATGATTTTGGAT
TAGAATTGAGATACTCCTA->AGAATTGAGATACTCCTAC
AGAATTGAGATACTCCTAC->GAATTGAGATACTCCTACT
AAATGGACTCGCTCCCTCC->AATGGACTCGCTCCCTCCT
AATGGACTCGCTCCCTCCT->ATGGACTCGCTCCCTCCTA
TGTAAAATCATCACTACTA->GTAAAATCATCACTACTAA
GTAAAATCATCACTACTAA->TAAAATCATCACTACTAAC
TTGGGGCTAACCTGGCGGC->TGGGGCTAACCTGGCGGCT
TGGGGCTAACCTGGCGGCT->GGGGCTAACCTGGCGGCTG
GATGCATCATTAAGCATAA->ATGCATCATTAAGCATAAG
ATGCATCATTAAGCATAAG->TGCATCATTAAGCATAAGC
TAACTTTACGGCTTACTAA->AACTTTACGGCTTACTAAC
AACTTTACGGCTTACTAAC->ACTTTACGGCTTACTAACT
TGTCAGCCGAGAGGCCCTG->GTCAGCCGAGAGGCCCTGT
GTCAGCCGAGAGGCCCTGT->TCAGCCGAGAGGCCCTGTA
CGTCACCGGGGCGAATATT->GTCACCGGGGCGAATATTT
GTCACCGGGGCGAATATTT->TCACCGGGGCGAATATTTT
AAACAAAAGATGCGTGGCA->AACAAAAGATGCGTGGCAG
AACAAAAGATGCGTGGCAG->ACAAAAGATGCGTGGCAGC
TAGACGATACCCCGGGCCA->AGACGATACCCCGGGCCAA
AGACGATACCCCGGGCCAA->GACGATACCCCGGGCCAAG
CACAACGACGCAACCTGTA->ACAACGACGCAACCTGTAA
ACAACGACGCAACCTGTAA->CAACGACGCAACCTGTAAA
CTGCCCGGAAACAAAAGAT->TGCCCGGAAACAAAAGATG
TGCCCGGAAACAAAAGATG->GCCCGGAAACAAAAGATGC
ACGTCGCTGTCTTTTGGAC->CGTCGCTGTCTTTTGGACC
CGTCGCTGTCTTTTGGACC->GTCGCTGTCTTTTGGACCT
GGCCTTTTGAACCATCTGC->GCCTTTTGAACCATCTGCA
GCCTTTTGAACCATCTGCA->CCTTTTGAACCATCTGCAA
TTCCCCAACGAGAGGACGG->TCCCCAACGAGAGGACGGT
TCCCCAACGAGAGGACGGT->CCCCAACGAGAGGACGGTG
GCACATAATTTTTATTTTG->CACATAATTTTTATTTTGA
CACATAATTTTTATTTTGA->ACATAATTTTTATTTTGAT
GGAATGCAAACGTCGCTGT->GAATGCAAACGTCGCTGTC
GAATGCAAACGTCGCTGTC->AATGCAAACGTCGCTGTCT
GGCTCGCGCCTCTTATTTT->GCTCGCGCCTCTTATTTTT
GCTCGCGCCTCTTATTTTT->CTCGCGCCTCTTATTTTTA
TTTTTCAGCCTCCCCGTCT->TTTTCAGCCTCCCCGTCTC
TTTTCAGCCTCCCCGTCTC->TTTCAGCCTCCCCGTCTCC
CGATGTATTCAGGACCCTC->GATGTATTCAGGACCCTCC
GATGTATTCAGGACCCTCC->ATGTATTCAGGACCCTCCG
TCGGACGTAGCACGTGGGC->CGGACGTAGCACGTGGGCT
CGGACGTAGCACGTGGGCT->GGACGTAGCACGTGGGCTT
AGACTTTACTAGCTGATGT->GACTTTACTAGCTGATGTA
GACTTTACTAGCTGATGTA->ACTTTACTAGCTGATGTAC
TTCCATAACGAACGCGTAT->TCCATAACGAACGCGTATT
TCCATAACGAACGCGTATT->CCATAACGAACGCGTATTC
CTTCAAGAGTAGTCACCGC->TTCAAGAGTAGTCACCGCT
TTCAAGAGTAGTCACCGCT->TCAAGAGTAGTCACCGCTC
CTCAGGGATTTCTTGGGAA->TCAGGGATTTCTTGGGAAG
GCGATCCGAACGCGACGAG->CGATCCGAACGCGACGAGC
CGATCCGAACGCGACGAGC->GATCCGAACGCGACGAGCC
TTAGTATAGTATTCAAGCC->TAGTATAGTATTCAAGCCA
TAGTATAGTATTCAAGCCA->AGTATAGTATTCAAGCCAC
CAGGACCCTCCGAAGTTCA->AGGACCCTCCGAAGTTCAT
AGGACCCTCCGAAGTTCAT->GGACCCTCCGAAGTTCATC
TGAGAAAAGCCGTTCAAAA->GAGAAAAGCCGTTCAAAAA
AAGCCCATCGCGCCTTTGA->AGCCCATCGCGCCTTTGAC
AGCCCATCGCGCCTTTGAC->GCCCATCGCGCCTTTGACG
TGCCTCGATCAAGACAGTT->GCCTCGATCAAGACAGTTG
GCCTCGATCAAGACAGTTG->CCTCGATCAAGACAGTTGT
AGCTAATGCGAGTACCCTG->GCTAATGCGAGTACCCTGC
GCTAATGCGAGTACCCTGC->CTAATGCGAGTACCCTGCG
GATGTTGATTTTATTCTTG->ATGTTGATTTTATTCTTGA
ATGTTGATTTTATTCTTGA->TGTTGATTTTATTCTTGAC
TCCTGTGGCCCTAGCTCAC->CCTGTGGCCCTAGCTCACA
CCTGTGGCCCTAGCTCACA->CTGTGGCCCTAGCTCACAC
TCCCACATCTAGACCCCTA->CCCACATCTAGACCCCTAA
CCCACATCTAGACCCCTAA->CCACATCTAGACCCCTAAC
AGTAGTGCCGGGTACCGGT->GTAGTGCCGGGTACCGGTA
GTAGTGCCGGGTACCGGTA->TAGTGCCGGGTACCGGTAG
AGGAGAACCATGACTGCCC->GGAGAACCATGACTGCCCG
GGAGAACCATGACTGCCCG->GAGAACCATGACTGCCCGG
CCCGATTGCCAGGAACGAT->CCGATTGCCAGGAACGATG
CTTTTGGACCTAATTGTGG->TTTTGGACCTAATTGTGGG
TTTTGGACCTAATTGTGGG->TTTGGACCTAATTGTGGGA
GACGCAACCTGTAAACGTC->ACGCAACCTGTAAACGTCC
ACGCAACCTGTAAACGTCC->CGCAACCTGTAAACGTCCT
ACCTGCACTTCACGGTGCG->CCTGCACTTCACGGTGCGA
CCTGCACTTCACGGTGCGA->CTGCACTTCACGGTGCGAT
ACCAAGAACCAACACAACG->CCAAGAACCAACACAACGA
CCAAGAACCAACACAACGA->CAAGAACCAACACAACGAC
ACTTTACTAGCTGATGTAC->CTTTACTAGCTGATGTACT
CTTTACTAGCTGATGTACT->TTTACTAGCTGATGTACTA
GGGACCTCCTATTACAATG->GGACCTCCTATTACAATGT
GGACCTCCTATTACAATGT->GACCTCCTATTACAATGTC
CAAGCCACTCCAATTTATT->AAGCCACTCCAATTTATTC
AAGCCACTCCAATTTATTC->AGCCACTCCAATTTATTCA
TGGGAAGATGTCACGATTC->GGGAAGATGTCACGATTCT
GGGAAGATGTCACGATTCT->GGAAGATGTCACGATTCTT
CCTATTACAATGTCTCGCT->CTATTACAATGTCTCGCTC
CTATTACAATGTCTCGCTC->TATTACAATGTCTCGCTCT
CCTCCACGCTGTCCCACAT->CTCCACGCTGTCCCACATC
CTCCACGCTGTCCCACATC->TCCACGCTGTCCCACATCT
ACATACATCGGATGACTCT->CATACATCGGATGACTCTT
CATACATCGGATGACTCTT->ATACATCGGATGACTCTTG
GGACCCTCCGAAGTTCATC->GACCCTCCGAAGTTCATCG
GACCCTCCGAAGTTCATCG->ACCCTCCGAAGTTCATCGG
CCGGGCCAAGACTATGGTT->CGGGCCAAGACTATGGTTC
CGGGCCAAGACTATGGTTC->GGGCCAAGACTATGGTTCG
GTGGCAGCATCCCAACGAG->TGGCAGCATCCCAACGAGC
TGGCAGCATCCCAACGAGC->GGCAGCATCCCAACGAGCT
GTGGAGTCAGAGGTACCGA->TGGAGTCAGAGGTACCGAT
GGAGCAGGTTAAAGTGGAG->GAGCAGGTTAAAGTGGAGT
GAGCAGGTTAAAGTGGAGT->AGCAGGTTAAAGTGGAGTC
GTCGCAGCTCTGAGGAAGG->TCGCAGCTCTGAGGAAGGG
GAGAGGCCCTGTAAAATCA->AGAGGCCCTGTAAAATCAT
AGAGGCCCTGTAAAATCAT->GAGGCCCTGTAAAATCATC
CCACTCAGATGGGATAGCA->CACTCAGATGGGATAGCAC
CACTCAGATGGGATAGCAC->ACTCAGATGGGATAGCACC
GGACTCGCTCCCTCCTACT->GACTCGCTCCCTCCTACTA
GACTCGCTCCCTCCTACTA->ACTCGCTCCCTCCTACTAA
TGATCAGTTTTGAAACGAG->GATCAGTTTTGAAACGAGG
GATCAGTTTTGAAACGAGG->ATCAGTTTTGAAACGAGGG
AGGGACTATTCGTACGCAT->GGGACTATTCGTACGCATT
GGGACTATTCGTACGCATT->GGACTATTCGTACGCATTA
CAGGTTAAAGTGGAGTCAG->AGGTTAAAGTGGAGTCAGA
CTTTAACCAGTAGACAGTC->TTTAACCAGTAGACAGTCG
TTTAACCAGTAGACAGTCG->TTAACCAGTAGACAGTCGC
TGTCTTTTGGACCTAATTG->GTCTTTTGGACCTAATTGT
GTCTTTTGGACCTAATTGT->TCTTTTGGACCTAATTGTG
AATAAAGCCTGGGTACCTT->ATAAAGCCTGGGTACCTTC
ATAAAGCCTGGGTACCTTC->TAAAGCCTGGGTACCTTCC
CTTGAAAGCCTGGGTACCT->TTGAAAGCCTGGGTACCTT
TTGAAAGCCTGGGTACCTT->TGAAAGCCTGGGTACCTTC
AGCCGAGAGGCCCTGTAAA->GCCGAGAGGCCCTGTAAAA
GCCGAGAGGCCCTGTAAAA->CCGAGAGGCCCTGTAAAAT
ATGTTAGTATAGTATTCAA->TGTTAGTATAGTATTCAAG
TGTTAGTATAGTATTCAAG->GTTAGTATAGTATTCAAGC
CAAACGTCGCTGTCTTTTG->AAACGTCGCTGTCTTTTGG
AAACGTCGCTGTCTTTTGG->AACGTCGCTGTCTTTTGGA
AGTTGCTCAAGGCTCCCCG->GTTGCTCAAGGCTCCCCGG
GTTGCTCAAGGCTCCCCGG->TTGCTCAAGGCTCCCCGGT
TCAGGACCCTCCGAATTTC->CAGGACCCTCCGAATTTCA,CAGGACCCTCCGAATTTCT
CAGGACCCTCCGAATTTCA->AGGACCCTCCGAATTTCAG
CCGGGGCGAATATTTTTTA->CGGGGCGAATATTTTTTAT
CGGGGCGAATATTTTTTAT->GGGGCGAATATTTTTTATC
GTCTTGCTACCAAGAACCA->TCTTGCTACCAAGAACCAA
TCTTGCTACCAAGAACCAA->CTTGCTACCAAGAACCAAC
TGTCACGATTCTTACCTAT->GTCACGATTCTTACCTATG
GTCACGATTCTTACCTATG->TCACGATTCTTACCTATGG
GCAACCTGTAAACGTCCTT->CAACCTGTAAACGTCCTTG
CAACCTGTAAACGTCCTTG->AACCTGTAAACGTCCTTGA
AAGTTCATCGGACGTAGCA->AGTTCATCGGACGTAGCAC
AGTTCATCGGACGTAGCAC->GTTCATCGGACGTAGCACG
AAATGTCTCAGTATGAGGT->AATGTCTCAGTATGAGGTC
AATGTCTCAGTATGAGGTC->ATGTCTCAGTATGAGGTCC
CTGTCAGCCGAGAGGCCCT->TGTCAGCCGAGAGGCCCTG
CCTCCTACTAAGACACCTA->CTCCTACTAAGACACCTAA
CTCCTACTAAGACACCTAA->TCCTACTAAGACACCTAAC
CCATTTACCGTTCCATGTC->CATTTACCGTTCCATGTCG
CATTTACCGTTCCATGTCG->ATTTACCGTTCCATGTCGA
CTCTCTAGGGTTATAACCA->TCTCTAGGGTTATAACCAA
TCTCTAGGGTTATAACCAA->CTCTAGGGTTATAACCAAG
TACGGCTTACTAACTGTCG->ACGGCTTACTAACTGTCGG
ACGGCTTACTAACTGTCGG->CGGCTTACTAACTGTCGGG
ATACCGGGAATGCCGGTTT->TACCGGGAATGCCGGTTTA
TACCGGGAATGCCGGTTTA->ACCGGGAATGCCGGTTTAC
GGTACCTTCCGATACAGCG->GTACCTTCCGATACAGCGC
GTACCTTCCGATACAGCGC->TACCTTCCGATACAGCGCC
GTCAACCTAAATGGACGAT->TCAACCTAAATGGACGATG
TCAACCTAAATGGACGATG->CAACCTAAATGGACGATGT
CAGCAGCTGGGATTTAGCC->AGCAGCTGGGATTTAGCCT
AGCAGCTGGGATTTAGCCT->GCAGCTGGGATTTAGCCTT
CACGGTGCGATGCGCTTAG->ACGGTGCGATGCGCTTAGA
ACGGTGCGATGCGCTTAGA->CGGTGCGATGCGCTTAGAT
TTCGAGTAATTCACGTCAC->TCGAGTAATTCACGTCACC
TCGAGTAATTCACGTCACC->CGAGTAATTCACGTCACCG
GAATAAAGCCTGGGTACCT->AATAAAGCCTGGGTACCTT
GTCACCGCTCTCTAGGGTT->TCACCGCTCTCTAGGGTTA
TCACCGCTCTCTAGGGTTA->CACCGCTCTCTAGGGTTAT
TCATCCTGATAGTCAACCT->CATCCTGATAGTCAACCTC
TCCATGTCGACCCACGACG->CCATGTCGACCCACGACGG
CCATGTCGACCCACGACGG->CATGTCGACCCACGACGGA
GTGGCCCTAGCTCACACCA->TGGCCCTAGCTCACACCAA
TGGCCCTAGCTCACACCAA->GGCCCTAGCTCACACCAAC
CCGGGAACTGTCAACCTAA->CGGGAACTGTCAACCTAAA
TCAGTAAGATAAGTCAAAG->CAGTAAGATAAGTCAAAGC
ACGCATTACTTGTATCATC->CGCATTACTTGTATCATCC
CGCATTACTTGTATCATCC->GCATTACTTGTATCATCCT
TCTAGGGTTATAACCAAGC->CTAGGGTTATAACCAAGCC
CTAGGGTTATAACCAAGCC->TAGGGTTATAACCAAGCCC
ATGTTCGCAAAATGGACTC->TGTTCGCAAAATGGACTCG
TGTTCGCAAAATGGACTCG->GTTCGCAAAATGGACTCGC
ATCCCTAGCCTAAATGTCT->TCCCTAGCCTAAATGTCTC
TCCCTAGCCTAAATGTCTC->CCCTAGCCTAAATGTCTCA
GTCTCAGGGATTTCTTGGG->TCTCAGGGATTTCTTGGGA
TCTCAGGGATTTCTTGGGA->CTCAGGGATTTCTTGGGAA
GTACCCTGCGCTCTACTTA->TACCCTGCGCTCTACTTAG
TACCCTGCGCTCTACTTAG->ACCCTGCGCTCTACTTAGG
ATAACGTAAGATCTCCGGG->TAACGTAAGATCTCCGGGT
TAACGTAAGATCTCCGGGT->AACGTAAGATCTCCGGGTA
CTAACTGTCGGGAGGAGAA->TAACTGTCGGGAGGAGAAC
TAACTGTCGGGAGGAGAAC->AACTGTCGGGAGGAGAACC
ACGCGACGAGCCAACACCC->CGCGACGAGCCAACACCCC
CGCGACGAGCCAACACCCC->GCGACGAGCCAACACCCCT
CTACTAACTTTACGGCTTA->TACTAACTTTACGGCTTAC
TACTAACTTTACGGCTTAC->ACTAACTTTACGGCTTACT
TCCTACTAAGACACCTAAC->CCTACTAAGACACCTAACT
AGCCTGGGTACCTTCCTCC->GCCTGGGTACCTTCCTCCA
GCCTGGGTACCTTCCTCCA->CCTGGGTACCTTCCTCCAT
CCTGGGTACCTTCCATAAC->CTGGGTACCTTCCATAACG
CTGGGTACCTTCCATAACG->TGGGTACCTTCCATAACGA
GGATACATACAGGAGTAAA->GATACATACAGGAGTAAAA
GATACATACAGGAGTAAAA->ATACATACAGGAGTAAAAG
AGGCTTTAACCAGTAGACA->GGCTTTAACCAGTAGACAG
ACTAACTTTACGGCTTACT->CTAACTTTACGGCTTACTA
TTTGAAACGAGGGACTATT->TTGAAACGAGGGACTATTC
TTGAAACGAGGGACTATTC->TGAAACGAGGGACTATTCG
CTAATGCGAGTACCCTGCG->TAATGCGAGTACCCTGCGC
TAATGCGAGTACCCTGCGC->AATGCGAGTACCCTGCGCT
ATAGTAGAGGCCCGCGGTT->TAGTAGAGGCCCGCGGTTG
TAGTAGAGGCCCGCGGTTG->AGTAGAGGCCCGCGGTTGA
CAAAGACCACGGAAGCCTA->AAAGACCACGGAAGCCTAT
AAAGACCACGGAAGCCTAT->AAGACCACGGAAGCCTATA
AGCCTGGGTACCTTCCATA->GCCTGGGTACCTTCCATAA
GCCTGGGTACCTTCCATAA->CCTGGGTACCTTCCATAAC
ATCATTCGTCGCACTGGAG->TCATTCGTCGCACTGGAGC
TCATTCGTCGCACTGGAGC->CATTCGTCGCACTGGAGCA
TCAATAACGTAAGATCTCC->CAATAACGTAAGATCTCCG
CAATAACGTAAGATCTCCG->AATAACGTAAGATCTCCGG
GTTCATCGGACGTAGCACG->TTCATCGGACGTAGCACGT
TTCATCGGACGTAGCACGT->TCATCGGACGTAGCACGTG
ATGATTTTGGATGAAGACT->TGATTTTGGATGAAGACTG
TGATTTTGGATGAAGACTG->GATTTTGGATGAAGACTGA
ACTATCAAAAGTTGCTCAA->CTATCAAAAGTTGCTCAAG
TCATTCCGCTGCACAGGCC->CATTCCGCTGCACAGGCCC
CATTCCGCTGCACAGGCCC->ATTCCGCTGCACAGGCCCG
CTTTAGTACATCAATGGAA->TTTAGTACATCAATGGAAT
TTTAGTACATCAATGGAAT->TTAGTACATCAATGGAATA
ACATCAGCAGCTGGGATTT->CATCAGCAGCTGGGATTTA
CATCAGCAGCTGGGATTTA->ATCAGCAGCTGGGATTTAG
GGGAGGCGATCCTGTGGCC->GGAGGCGATCCTGTGGCCC
GGAGGCGATCCTGTGGCCC->GAGGCGATCCTGTGGCCCT
TCATCTACGCCATTTACCG->CATCTACGCCATTTACCGT
CATCTACGCCATTTACCGT->ATCTACGCCATTTACCGTT
GATAGACGATACCCCGGGC->ATAGACGATACCCCGGGCC
ATAGACGATACCCCGGGCC->TAGACGATACCCCGGGCCA
GCTGGGATTTAGCCTTGGC->CTGGGATTTAGCCTTGGCT
CTGGGATTTAGCCTTGGCT->TGGGATTTAGCCTTGGCTC
GGTCCCCGCAAAATACCGG->GTCCCCGCAAAATACCGGG
GTCCCCGCAAAATACCGGG->TCCCCGCAAAATACCGGGA
ATCAATGGAATATGCCTCG->TCAATGGAATATGCCTCGA
TCAATGGAATATGCCTCGA->CAATGGAATATGCCTCGAT
ATACATCGGATGACTCTTG->TACATCGGATGACTCTTGG
TACATCGGATGACTCTTGG->ACATCGGATGACTCTTGGT
GCAGCTCTGAGGAAGGGAT->CAGCTCTGAGGAAGGGATG
CCCTTCTGTCAGCCGAGAG->CCTTCTGTCAGCCGAGAGG
CCTTCTGTCAGCCGAGAGG->CTTCTGTCAGCCGAGAGGC
CCGAGGGCGCAGTAGTGCC->CGAGGGCGCAGTAGTGCCG
CGAGGGCGCAGTAGTGCCG->GAGGGCGCAGTAGTGCCGG
GTTGAGTAACGGCCTGTCG->TTGAGTAACGGCCTGTCGA
TTGAGTAACGGCCTGTCGA->TGAGTAACGGCCTGTCGAA
CGACGCAACCTGTAAACGT->GACGCAACCTGTAAACGTC
GTCAGCGACTCAGCAGAAT->TCAGCGACTCAGCAGAATT
TCAGCGACTCAGCAGAATT->CAGCGACTCAGCAGAATTC
CCCGCAAAATACCGGGAAT->CCGCAAAATACCGGGAATG
CCGCAAAATACCGGGAATG->CGCAAAATACCGGGAATGC
AAATCATCACTACTAACTT->AATCATCACTACTAACTTT
AATCATCACTACTAACTTT->ATCATCACTACTAACTTTA
TTCCTCCATCCCGATGTAT->TCCTCCATCCCGATGTATT
TCCTCCATCCCGATGTATT->CCTCCATCCCGATGTATTC
TACTGATCAGTTTTGAAAC->ACTGATCAGTTTTGAAACG
ACTGATCAGTTTTGAAACG->CTGATCAGTTTTGAAACGA
CAATGTCTCGCTCTAGACC->AATGTCTCGCTCTAGACCG
AGTAATTCACGTCACCGGG->GTAATTCACGTCACCGGGG
TACTCAGCTGTATTCAGGA->ACTCAGCTGTATTCAGGAC
ACTCAGCTGTATTCAGGAC->CTCAGCTGTATTCAGGACC
GCTGAAGACTTTACTAGCT->CTGAAGACTTTACTAGCTG
CTGAAGACTTTACTAGCTG->TGAAGACTTTACTAGCTGA
TCCGCTCCAGCGCCCGATC->CCGCTCCAGCGCCCGATCT
CCGCTCCAGCGCCCGATCT->CGCTCCAGCGCCCGATCTG
AGTGGAGTCAGAGGTACCG->GTGGAGTCAGAGGTACCGA
ACTACTAACTTTACGGCTT->CTACTAACTTTACGGCTTA
TCATTAAGCATAAGCAGTG->CATTAAGCATAAGCAGTGC
CATTAAGCATAAGCAGTGC->ATTAAGCATAAGCAGTGCT
CCTAAATGGACGATGTCGC->CTAAATGGACGATGTCGCA
GGGTACCTTCCTCCATCCC->GGTACCTTCCTCCATCCCG
GGTACCTTCCTCCATCCCG->GTACCTTCCTCCATCCCGA
TTACGGCTTACTAACTGTC->TACGGCTTACTAACTGTCG
TGAACCATCTGCAAAGACC->GAACCATCTGCAAAGACCA
GAACCATCTGCAAAGACCA->AACCATCTGCAAAGACCAC
ATTTCTTGGGAAGATGTCA->TTTCTTGGGAAGATGTCAC
TTTCTTGGGAAGATGTCAC->TTCTTGGGAAGATGTCACG
TGGGTACCTTCCATAACGA->GGGTACCTTCCATAACGAA
CTATAGTATCATTCGTCGC->TATAGTATCATTCGTCGCA
TATAGTATCATTCGTCGCA->ATAGTATCATTCGTCGCAC
GCAATAGGATACATACAGG->CAATAGGATACATACAGGA
CAATAGGATACATACAGGA->AATAGGATACATACAGGAG
CCGTGGGCGAGCTCCTGCA->CGTGGGCGAGCTCCTGCAC
CGTGGGCGAGCTCCTGCAC->GTGGGCGAGCTCCTGCACA
GCGAATATTTTTTATCTGG->CGAATATTTTTTATCTGGA
CGAATATTTTTTATCTGGA->GAATATTTTTTATCTGGAC
GCCCGGAAACAAAAGATGC->CCCGGAAACAAAAGATGCG
CCCGGAAACAAAAGATGCG->CCGGAAACAAAAGATGCGT
TATACCCCTTATAGCTAAT->ATACCCCTTATAGCTAATG
ATACCCCTTATAGCTAATG->TACCCCTTATAGCTAATGC
GTGGGCGAGCTCCTGCACA->TGGGCGAGCTCCTGCACAT
TGGGCGAGCTCCTGCACAT->GGGCGAGCTCCTGCACATC
ATGTATTCAGGACCCTCCG->TGTATTCAGGACCCTCCGA
GTTTTGAAACGAGGGACTA->TTTTGAAACGAGGGACTAT
TTTTGAAACGAGGGACTAT->TTTGAAACGAGGGACTATT
AACGAGCTTTTAATGTTAG->ACGAGCTTTTAATGTTAGT
ACGAGCTTTTAATGTTAGT->CGAGCTTTTAATGTTAGTA
CCCATCGCGCCTTTGACGG->CCATCGCGCCTTTGACGGT
CCATCGCGCCTTTGACGGT->CATCGCGCCTTTGACGGTG
CAGGACCCTCCGAATTTCT->AGGACCCTCCGAATTTCTG
TATTCTTGACACCTTATAC->ATTCTTGACACCTTATACC
AATAACGTAAGATCTCCGG->ATAACGTAAGATCTCCGGG
CCGATACGTGCTGAAGACT->CGATACGTGCTGAAGACTT
CGATACGTGCTGAAGACTT->GATACGTGCTGAAGACTTT
GATTTTATTCTTGACACCT->ATTTTATTCTTGACACCTT
TGGACCTAATTGTGGGAGG->GGACCTAATTGTGGGAGGC
GGACCTAATTGTGGGAGGC->GACCTAATTGTGGGAGGCG
ACCGGGAACTGTCAACCTA->CCGGGAACTGTCAACCTAA
ACCTGGCGGCTGGGATGTT->CCTGGCGGCTGGGATGTTG
CCTGGCGGCTGGGATGTTG->CTGGCGGCTGGGATGTTGA
AGAGGCTCGCGCCTCTTAT->GAGGCTCGCGCCTCTTATT
GAGGCTCGCGCCTCTTATT->AGGCTCGCGCCTCTTATTT
GACGGTGCTGGAGGATATT->ACGGTGCTGGAGGATATTC
ACGGTGCTGGAGGATATTC->CGGTGCTGGAGGATATTCG
CCCTGCGCTCTACTTAGGA->CCTGCGCTCTACTTAGGAC
CCTGCGCTCTACTTAGGAC->CTGCGCTCTACTTAGGACA
TAGAATAAAGCCTGGGTAC->AGAATAAAGCCTGGGTACC
AGAATAAAGCCTGGGTACC->GAATAAAGCCTGGGTACCT
GATAGCACCCTCCTCAACG->ATAGCACCCTCCTCAACGT
ATAGCACCCTCCTCAACGT->TAGCACCCTCCTCAACGTG
TGTCGTCGCGCCGAGGGCG->GTCGTCGCGCCGAGGGCGC
GTCGTCGCGCCGAGGGCGC->TCGTCGCGCCGAGGGCGCA
ACCTCCTATTACAATGTCT->CCTCCTATTACAATGTCTC
CCTCCTATTACAATGTCTC->CTCCTATTACAATGTCTCG
GATGTTCGCAAAATGGACT->ATGTTCGCAAAATGGACTC
ATTCTTGACACCTTATACC->TTCTTGACACCTTATACCA
TATTGGGGCTAACCTGGCG->ATTGGGGCTAACCTGGCGG
ATTGGGGCTAACCTGGCGG->TTGGGGCTAACCTGGCGGC
CTGTCGAAGTAACCCACTC->TGTCGAAGTAACCCACTCA
TGTCGAAGTAACCCACTCA->GTCGAAGTAACCCACTCAG
GGATTTAGCCTTGGCTCAG->GATTTAGCCTTGGCTCAGT
GATTTAGCCTTGGCTCAGT->ATTTAGCCTTGGCTCAGTT
AGTATAGTATTCAAGCCAC->GTATAGTATTCAAGCCACT
CCGGTAGGAAGCGAATTAT->CGGTAGGAAGCGAATTATA
CGGTAGGAAGCGAATTATA->GGTAGGAAGCGAATTATAG
CGTGCTGAAGACTTTACTA->GTGCTGAAGACTTTACTAG
GTGCTGAAGACTTTACTAG->TGCTGAAGACTTTACTAGC
CCGGTAGTCAAGGCTTTAA->CGGTAGTCAAGGCTTTAAC
CGGTAGTCAAGGCTTTAAC->GGTAGTCAAGGCTTTAACC
TTACTTGTATCATCCTGAT->TACTTGTATCATCCTGATA
TACTTGTATCATCCTGATA->ACTTGTATCATCCTGATAG
ACCCCTTCTGTCAGCCGAG->CCCCTTCTGTCAGCCGAGA
CCCCTTCTGTCAGCCGAGA->CCCTTCTGTCAGCCGAGAG
TTTGATCATCTACGCCATT->TTGATCATCTACGCCATTT
TTGATCATCTACGCCATTT->TGATCATCTACGCCATTTA
ACTTTACGGCTTACTAACT->CTTTACGGCTTACTAACTG
CTTTACGGCTTACTAACTG->TTTACGGCTTACTAACTGT
TATCAAAAGTTGCTCAAGG->ATCAAAAGTTGCTCAAGGC
ATCAAAAGTTGCTCAAGGC->TCAAAAGTTGCTCAAGGCT
CGGTCTTGCTACCAAGAAC->GGTCTTGCTACCAAGAACC
GGTCTTGCTACCAAGAACC->GTCTTGCTACCAAGAACCA
ATCAAGACAGTTGTTTCGA->TCAAGACAGTTGTTTCGAG
TCAAGACAGTTGTTTCGAG->CAAGACAGTTGTTTCGAGT
CTCTACTTAGGACATGTCG->TCTACTTAGGACATGTCGT
TCTACTTAGGACATGTCGT->CTACTTAGGACATGTCGTC
CTTCTGTCAGCCGAGAGGC->TTCTGTCAGCCGAGAGGCC
GATCTCCGGGTAAATCCCA->ATCTCCGGGTAAATCCCAG
ATCTCCGGGTAAATCCCAG->TCTCCGGGTAAATCCCAGG
ATCGGATGACTCTTGGTTA->TCGGATGACTCTTGGTTAG
TCGGATGACTCTTGGTTAG->CGGATGACTCTTGGTTAGT
GGCTCAGTTCCCCAACGAG->GCTCAGTTCCCCAACGAGA
GCTCAGTTCCCCAACGAGA->CTCAGTTCCCCAACGAGAG
TTTACGTCAGCGACTCAGC->TTACGTCAGCGACTCAGCA
TTTGGACCTAATTGTGGGA->TTGGACCTAATTGTGGGAG
TGCTGGAGGATATTCGTAA->GCTGGAGGATATTCGTAAG
GCTGGAGGATATTCGTAAG->CTGGAGGATATTCGTAAGC
CTAACCTAGGTGTTTTAGC->TAACCTAGGTGTTTTAGCA
TAACCTAGGTGTTTTAGCA->AACCTAGGTGTTTTAGCAA
AAGACTATGGTTCGCTGTT->AGACTATGGTTCGCTGTTA
AGACTATGGTTCGCTGTTA->GACTATGGTTCGCTGTTAC
GACCTAATTGTGGGAGGCG->ACCTAATTGTGGGAGGCGA
CAGTCGCAGCTCTGAGGAA->AGTCGCAGCTCTGAGGAAG
AGTCGCAGCTCTGAGGAAG->GTCGCAGCTCTGAGGAAGG
GTATTCAAGCCACTCCAAT->TATTCAAGCCACTCCAATT
TATTCAAGCCACTCCAATT->ATTCAAGCCACTCCAATTT
CCCAGGAGAGGCTCGCGCC->CCAGGAGAGGCTCGCGCCT
GCCTAAATGTCTCAGTATG->CCTAAATGTCTCAGTATGA
CCTAAATGTCTCAGTATGA->CTAAATGTCTCAGTATGAG
GTGGGCGGTCTTGCTACCA->TGGGCGGTCTTGCTACCAA
TGGGCGGTCTTGCTACCAA->GGGCGGTCTTGCTACCAAG
GGACGCGTTATACCTATTC->GACGCGTTATACCTATTCG
GGGTACCTTCCATAACGAA->GGTACCTTCCATAACGAAC
GACTGACTCAAGGGGTCTG->ACTGACTCAAGGGGTCTGG
ACTGACTCAAGGGGTCTGG->CTGACTCAAGGGGTCTGGA
CCCAAACTGTGACCTGCAC->CCAAACTGTGACCTGCACT
CCAAACTGTGACCTGCACT->CAAACTGTGACCTGCACTT
ATGAAGACTGACTCAAGGG->TGAAGACTGACTCAAGGGG
TGAAGACTGACTCAAGGGG->GAAGACTGACTCAAGGGGT
CATAATTTTTATTTTGATC->ATAATTTTTATTTTGATCA
ATAATTTTTATTTTGATCA->TAATTTTTATTTTGATCAT
GACGAGCCAACACCCCTTC->ACGAGCCAACACCCCTTCT
ACGAGCCAACACCCCTTCT->CGAGCCAACACCCCTTCTG
GATGTACTATACCCCTTAT->ATGTACTATACCCCTTATA
ATGTACTATACCCCTTATA->TGTACTATACCCCTTATAG
TTCCGTGGGCGAGCTCCTG->TCCGTGGGCGAGCTCCTGC
TCCGTGGGCGAGCTCCTGC->CCGTGGGCGAGCTCCTGCA
GGGGCACATAATTTTTATT->GGGCACATAATTTTTATTT
GGGCACATAATTTTTATTT->GGCACATAATTTTTATTTT
CCGATACAGCGCCGTATTC->CGATACAGCGCCGTATTCA
CGATACAGCGCCGTATTCA->GATACAGCGCCGTATTCAG
GTCGAAGTAACCCACTCAG->TCGAAGTAACCCACTCAGA
TAGTGCCGGGTACCGGTAG->AGTGCCGGGTACCGGTAGT
AGTGCCGGGTACCGGTAGT->GTGCCGGGTACCGGTAGTC
CGCAACCTGTAAACGTCCT->GCAACCTGTAAACGTCCTT
GGGAGGAGAACCATGACTG->GGAGGAGAACCATGACTGC
GGAGGAGAACCATGACTGC->GAGGAGAACCATGACTGCC
GGGGCTAACCTGGCGGCTG->GGGCTAACCTGGCGGCTGG
TGAGATACTCCTACTTGAA->GAGATACTCCTACTTGAAA
GAGATACTCCTACTTGAAA->AGATACTCCTACTTGAAAG
TAGCTGATGTACTATACCC->AGCTGATGTACTATACCCC
AGCTGATGTACTATACCCC->GCTGATGTACTATACCCCT
TTTAGCCTTGGCTCAGTTC->TTAGCCTTGGCTCAGTTCC
TTAGCCTTGGCTCAGTTCC->TAGCCTTGGCTCAGTTCCC
GGAACTGTCAACCTAAATG->GAACTGTCAACCTAAATGG
CACGCTGTCCCACATCTAG->ACGCTGTCCCACATCTAGA
ACGCTGTCCCACATCTAGA->CGCTGTCCCACATCTAGAC
CATCTGCAAAGACCACGGA->ATCTGCAAAGACCACGGAA
ATCTGCAAAGACCACGGAA->TCTGCAAAGACCACGGAAG
ACTCGCTCCCTCCTACTAA->CTCGCTCCCTCCTACTAAG
CATGGCTGCGTCAGTAAGA->ATGGCTGCGTCAGTAAGAT
ATGGCTGCGTCAGTAAGAT->TGGCTGCGTCAGTAAGATA
GCGATGCGCTTAGATGCAT->CGATGCGCTTAGATGCATC
CGATGCGCTTAGATGCATC->GATGCGCTTAGATGCATCA
CTCAAGGGGTCTGGACTCT->TCAAGGGGTCTGGACTCTA
TCAAGGGGTCTGGACTCTA->CAAGGGGTCTGGACTCTAT
TGTTTCGAGTAATTCACGT->GTTTCGAGTAATTCACGTC
GTTTCGAGTAATTCACGTC->TTTCGAGTAATTCACGTCA
TATTTTTAGAATTGAGATA->ATTTTTAGAATTGAGATAC
ATTTTTAGAATTGAGATAC->TTTTTAGAATTGAGATACT
TGACCTGCACTTCACGGTG->GACCTGCACTTCACGGTGC
GACCTGCACTTCACGGTGC->ACCTGCACTTCACGGTGCG
GTCTCGCTCTAGACCGTCC->TCTCGCTCTAGACCGTCCT
TCTCGCTCTAGACCGTCCT->CTCGCTCTAGACCGTCCTG
CGAATTTCTGCGATCCGAA->GAATTTCTGCGATCCGAAC
GAATTTCTGCGATCCGAAC->AATTTCTGCGATCCGAACG
CTTGACGTCGCGTCGAAGG->TTGACGTCGCGTCGAAGGG
TTGACGTCGCGTCGAAGGG->TGACGTCGCGTCGAAGGGG
ACCTTCCCATACTCAGCTG->CCTTCCCATACTCAGCTGT
CCTTCCCATACTCAGCTGT->CTTCCCATACTCAGCTGTA
TCCTGATAGTCAACCTCCA->CCTGATAGTCAACCTCCAC
CCTGATAGTCAACCTCCAC->CTGATAGTCAACCTCCACG
CTGTCTAGAATAAAGCCTG->TGTCTAGAATAAAGCCTGG
TGTCTAGAATAAAGCCTGG->GTCTAGAATAAAGCCTGGG
AACGTCGCTGTCTTTTGGA->ACGTCGCTGTCTTTTGGAC
TCACTACTAACTTTACGGC->CACTACTAACTTTACGGCT
CACTACTAACTTTACGGCT->ACTACTAACTTTACGGCTT
CGCATCGGGACCTCCTATT->GCATCGGGACCTCCTATTA
GCATCGGGACCTCCTATTA->CATCGGGACCTCCTATTAC
TAGCACGTGGGCTTTATAA->AGCACGTGGGCTTTATAAC
AGCACGTGGGCTTTATAAC->GCACGTGGGCTTTATAACA
CAAGACTATGGTTCGCTGT->AAGACTATGGTTCGCTGTT
ATTCGTCGCACTGGAGCAG->TTCGTCGCACTGGAGCAGG
TTCGTCGCACTGGAGCAGG->TCGTCGCACTGGAGCAGGT
TATTCAGGACCCTCCGAAG->ATTCAGGACCCTCCGAAGT
CTACTTAGGACATGTCGTC->TACTTAGGACATGTCGTCG
GGAATATGCCTCGATCAAG->GAATATGCCTCGATCAAGA
GAATATGCCTCGATCAAGA->AATATGCCTCGATCAAGAC
TTTTATTTTGATCATCTAC->TTTATTTTGATCATCTACG
TTTATTTTGATCATCTACG->TTATTTTGATCATCTACGC
GTCAGAGGTACCGATACGT->TCAGAGGTACCGATACGTG
TCAGAGGTACCGATACGTG->CAGAGGTACCGATACGTGC
ATGGACTCGCTCCCTCCTA->TGGACTCGCTCCCTCCTAC
TGGACTCGCTCCCTCCTAC->GGACTCGCTCCCTCCTACT
CCAAGACTATGGTTCGCTG->CAAGACTATGGTTCGCTGT
ACCTCCACGCTGTCCCACA->CCTCCACGCTGTCCCACAT
ATTCCGCTGCACAGGCCCG->TTCCGCTGCACAGGCCCGA
TTCCGCTGCACAGGCCCGA->TCCGCTGCACAGGCCCGAT
GTACCTTCCTCCATCCCGA->TACCTTCCTCCATCCCGAT
TATTCGTACGCATTACTTG->ATTCGTACGCATTACTTGT
ATTCGTACGCATTACTTGT->TTCGTACGCATTACTTGTA
CTCACACCAACTAACGAGA->TCACACCAACTAACGAGAC
TCACACCAACTAACGAGAC->CACACCAACTAACGAGACG
ATCCCGATGTATTCAGGAC->TCCCGATGTATTCAGGACC
TCCCGATGTATTCAGGACC->CCCGATGTATTCAGGACCC
CAGGAGTAAAAGCCTGGGT->AGGAGTAAAAGCCTGGGTA
CTAGAATAAAGCCTGGGTA->TAGAATAAAGCCTGGGTAC
CACGACGGATCAAGGTCAC->ACGACGGATCAAGGTCACG
ACGACGGATCAAGGTCACG->CGACGGATCAAGGTCACGG
GCCTGTCGAAGTAACCCAC->CCTGTCGAAGTAACCCACT
CCTGTCGAAGTAACCCACT->CTGTCGAAGTAACCCACTC
CAAACTGTGACCTGCACTT->AAACTGTGACCTGCACTTC
GCCGGGTACCGGTAGTCAA->CCGGGTACCGGTAGTCAAG
CCGGGTACCGGTAGTCAAG->CGGGTACCGGTAGTCAAGG
GTGGGAGGCGATCCTGTGG->TGGGAGGCGATCCTGTGGC
TGGGAGGCGATCCTGTGGC->GGGAGGCGATCCTGTGGCC
CCGCTGCACAGGCCCGATT->CGCTGCACAGGCCCGATTG
CGCTGCACAGGCCCGATTG->GCTGCACAGGCCCGATTGC
AACGTCCTTGACGTCGCGT->ACGTCCTTGACGTCGCGTC
ACGTCCTTGACGTCGCGTC->CGTCCTTGACGTCGCGTCG
CGAGCCAACACCCCTTCTG->GAGCCAACACCCCTTCTGT
ACGATACCCCGGGCCAAGA->CGATACCCCGGGCCAAGAC
CGATACCCCGGGCCAAGAC->GATACCCCGGGCCAAGACT
AACGAACGCGTATTCAGGA->ACGAACGCGTATTCAGGAC
ACGAACGCGTATTCAGGAC->CGAACGCGTATTCAGGACC
TCGCTCTAGACCGTCCTGT->CGCTCTAGACCGTCCTGTG
CGCTCTAGACCGTCCTGTG->GCTCTAGACCGTCCTGTGG
TTCGTACGCATTACTTGTA->TCGTACGCATTACTTGTAT
CGCAGTAGTGCCGGGTACC->GCAGTAGTGCCGGGTACCG
GCAGTAGTGCCGGGTACCG->CAGTAGTGCCGGGTACCGG
GCGCCTCTTATTTTTAGAA->CGCCTCTTATTTTTAGAAT
CGCCTCTTATTTTTAGAAT->GCCTCTTATTTTTAGAATT
TACGCCATTTACCGTTCCA->ACGCCATTTACCGTTCCAT
ACGCCATTTACCGTTCCAT->CGCCATTTACCGTTCCATG
AGTCAACCTCCACGCTGTC->GTCAACCTCCACGCTGTCC
GTCAACCTCCACGCTGTCC->TCAACCTCCACGCTGTCCC
TCAAGGCTTTAACCAGTAG->CAAGGCTTTAACCAGTAGA
AGAGGACGGTGTATCCGCC->GAGGACGGTGTATCCGCCC
GAGGACGGTGTATCCGCCC->AGGACGGTGTATCCGCCCT
TCGCTGTCTTTTGGACCTA->CGCTGTCTTTTGGACCTAA
CGCTGTCTTTTGGACCTAA->GCTGTCTTTTGGACCTAAT
TTTTTAGAATTGAGATACT->TTTTAGAATTGAGATACTC
AAGCCTATAGTATCATTCG->AGCCTATAGTATCATTCGT
AGCCTATAGTATCATTCGT->GCCTATAGTATCATTCGTC
TAGGTGTTTTAGCAATAGG->AGGTGTTTTAGCAATAGGA
AGGTGTTTTAGCAATAGGA->GGTGTTTTAGCAATAGGAT
CAAAAGATGCGTGGCAGCA->AAAAGATGCGTGGCAGCAT
AAAAGATGCGTGGCAGCAT->AAAGATGCGTGGCAGCATC
ATCCGAACGCGACGAGCCA->TCCGAACGCGACGAGCCAA
TCCGAACGCGACGAGCCAA->CCGAACGCGACGAGCCAAC
TGTGGCCCTAGCTCACACC->GTGGCCCTAGCTCACACCA
GGAATGCCGGTTTACCTTC->GAATGCCGGTTTACCTTCA
GAATGCCGGTTTACCTTCA->AATGCCGGTTTACCTTCAA
TCATCGGACGTAGCACGTG->CATCGGACGTAGCACGTGG
CATCGGACGTAGCACGTGG->ATCGGACGTAGCACGTGGG
CGGTTTACCTTCAAGAGTA->GGTTTACCTTCAAGAGTAG
GGTTTACCTTCAAGAGTAG->GTTTACCTTCAAGAGTAGT
GGGCGGTCTTGCTACCAAG->GGCGGTCTTGCTACCAAGA
AGCACCCTCCTCAACGTGA->GCACCCTCCTCAACGTGAT
GCACCCTCCTCAACGTGAT->CACCCTCCTCAACGTGATT
CTGTATTCAGGACCCTCCG->TGTATTCAGGACCCTCCGA
TGTATTCAGGACCCTCCGA->GTATTCAGGACCCTCCGAA,GTATTCAGGACCCTCCGAA
GGAAGCCTATAGTATCATT->GAAGCCTATAGTATCATTC
GAAGCCTATAGTATCATTC->AAGCCTATAGTATCATTCG
CCGTTCAAAAAGTATGATA->CGTTCAAAAAGTATGATAG
TTCTTGACACCTTATACCA->TCTTGACACCTTATACCAC
GATACCCCGGGCCAAGACT->ATACCCCGGGCCAAGACTA
CGCTCTACTTAGGACATGT->GCTCTACTTAGGACATGTC
GCTCTACTTAGGACATGTC->CTCTACTTAGGACATGTCG
CTTGTATCATCCTGATAGT->TTGTATCATCCTGATAGTC
TTGTATCATCCTGATAGTC->TGTATCATCCTGATAGTCA
ACGGATCAAGGTCACGGCG->CGGATCAAGGTCACGGCGC
CGGATCAAGGTCACGGCGC->GGATCAAGGTCACGGCGCA
TGGACGATGTCGCATCGGG->GGACGATGTCGCATCGGGA
GGACGATGTCGCATCGGGA->GACGATGTCGCATCGGGAC
ATGATAGACGATACCCCGG->TGATAGACGATACCCCGGG
TAAACGTCCTTGACGTCGC->AAACGTCCTTGACGTCGCG
AAACGTCCTTGACGTCGCG->AACGTCCTTGACGTCGCGT
TGGTTAGTTTTTCAGCCTC->GGTTAGTTTTTCAGCCTCC
GGTTAGTTTTTCAGCCTCC->GTTAGTTTTTCAGCCTCCC
TAACGCCCCACGACACCGG->AACGCCCCACGACACCGGG
AACGCCCCACGACACCGGG->ACGCCCCACGACACCGGGA
CTGCACTTCACGGTGCGAT->TGCACTTCACGGTGCGATG
CCTATAGTATCATTCGTCG->CTATAGTATCATTCGTCGC
CGGTTGAGTAACGGCCTGT->GGTTGAGTAACGGCCTGTC
GGTTGAGTAACGGCCTGTC->GTTGAGTAACGGCCTGTCG
ACACCCCTTCTGTCAGCCG->CACCCCTTCTGTCAGCCGA
CACCCCTTCTGTCAGCCGA->ACCCCTTCTGTCAGCCGAG
TCTAGACCGTCCTGTGGGC->CTAGACCGTCCTGTGGGCG
CTAGACCGTCCTGTGGGCG->TAGACCGTCCTGTGGGCGG
GAGCCAACACCCCTTCTGT->AGCCAACACCCCTTCTGTC
AGCCAACACCCCTTCTGTC->GCCAACACCCCTTCTGTCA
CTCCTGCACATCAGCAGCT->TCCTGCACATCAGCAGCTG
TCCTGCACATCAGCAGCTG->CCTGCACATCAGCAGCTGG
ATAGTATCATTCGTCGCAC->TAGTATCATTCGTCGCACT
TAGTATCATTCGTCGCACT->AGTATCATTCGTCGCACTG
GCCCTCACGCTACTGAGAA->CCCTCACGCTACTGAGAAA
CCCTCACGCTACTGAGAAA->CCTCACGCTACTGAGAAAA
TAGCACCCTCCTCAACGTG->AGCACCCTCCTCAACGTGA
TAACGGCCTGTCGAAGTAA->AACGGCCTGTCGAAGTAAC
AACGGCCTGTCGAAGTAAC->ACGGCCTGTCGAAGTAACC
GGACGTAGCACGTGGGCTT->GACGTAGCACGTGGGCTTT
GACGTAGCACGTGGGCTTT->ACGTAGCACGTGGGCTTTA
ACTAGCTGATGTACTATAC->CTAGCTGATGTACTATACC
CTAGCTGATGTACTATACC->TAGCTGATGTACTATACCC
GAGTAAAAGCCTGGGTACC->AGTAAAAGCCTGGGTACCT
AGTAAAAGCCTGGGTACCT->GTAAAAGCCTGGGTACCTT
GAACCGCCCCAAACTGTGA->AACCGCCCCAAACTGTGAC
AACCGCCCCAAACTGTGAC->ACCGCCCCAAACTGTGACC
AGTAGAGGCCCGCGGTTGA->GTAGAGGCCCGCGGTTGAG
GTAGAGGCCCGCGGTTGAG->TAGAGGCCCGCGGTTGAGT
TAAAGTGGAGTCAGAGGTA->AAAGTGGAGTCAGAGGTAC
AAAGTGGAGTCAGAGGTAC->AAGTGGAGTCAGAGGTACC
TGCATCATTAAGCATAAGC->GCATCATTAAGCATAAGCA
TCCAATTTATTCAATAACG->CCAATTTATTCAATAACGT
CCAATTTATTCAATAACGT->CAATTTATTCAATAACGTA
CTTCACGGTGCGATGCGCT->TTCACGGTGCGATGCGCTT
TTCACGGTGCGATGCGCTT->TCACGGTGCGATGCGCTTA
AAATCCCAGGAGAGGCTCG->AATCCCAGGAGAGGCTCGC
AATCCCAGGAGAGGCTCGC->ATCCCAGGAGAGGCTCGCG
CGAAGTTCATCGGACGTAG->GAAGTTCATCGGACGTAGC
GAAGTTCATCGGACGTAGC->AAGTTCATCGGACGTAGCA
GAGGCCCTGTAAAATCATC->AGGCCCTGTAAAATCATCA
GAGGCGATCCTGTGGCCCT->AGGCGATCCTGTGGCCCTA
GGATCAAGGTCACGGCGCA->GATCAAGGTCACGGCGCAG
GATCAAGGTCACGGCGCAG->ATCAAGGTCACGGCGCAGA
ACTGCCCGGAAACAAAAGA->CTGCCCGGAAACAAAAGAT
GAACGATGATTTTGGATGA->AACGATGATTTTGGATGAA
AACGATGATTTTGGATGAA->ACGATGATTTTGGATGAAG
TAAGTCAAAGCCTGGGTAC->AAGTCAAAGCCTGGGTACC
AAGTCAAAGCCTGGGTACC->AGTCAAAGCCTGGGTACCT
GAAGGGGTCAGTTCGGCCT->AAGGGGTCAGTTCGGCCTT
AAGGGGTCAGTTCGGCCTT->AGGGGTCAGTTCGGCCTTT
CCGGAAACAAAAGATGCGT->CGGAAACAAAAGATGCGTG
CGGAAACAAAAGATGCGTG->GGAAACAAAAGATGCGTGG
CGCGTTATACCTATTCGTT->GCGTTATACCTATTCGTTG
GCGTTATACCTATTCGTTG->CGTTATACCTATTCGTTGG
CCGGGTAAATCCCAGGAGA->CGGGTAAATCCCAGGAGAG
CGGGTAAATCCCAGGAGAG->GGGTAAATCCCAGGAGAGG
TAAATCCCAGGAGAGGCTC->AAATCCCAGGAGAGGCTCG
ACATCGGATGACTCTTGGT->CATCGGATGACTCTTGGTT
CATCGGATGACTCTTGGTT->ATCGGATGACTCTTGGTTA
AGGAACGATGATTTTGGAT->GGAACGATGATTTTGGATG
ACGTCGCGTCGAAGGGGTC->CGTCGCGTCGAAGGGGTCA
CGTCGCGTCGAAGGGGTCA->GTCGCGTCGAAGGGGTCAG
AAAGCCTGGGTACCTTCCT->AAGCCTGGGTACCTTCCTC
AAGCCTGGGTACCTTCCTC->AGCCTGGGTACCTTCCTCC
TATGAGGTCCCCGCAAAAT->ATGAGGTCCCCGCAAAATA
ATGAGGTCCCCGCAAAATA->TGAGGTCCCCGCAAAATAC
TCTGGACGCTTAACATACA->CTGGACGCTTAACATACAT
CTGGACGCTTAACATACAT->TGGACGCTTAACATACATC
ATGCGAGTACCCTGCGCTC->TGCGAGTACCCTGCGCTCT
TGCGAGTACCCTGCGCTCT->GCGAGTACCCTGCGCTCTA
TAGCAATAGGATACATACA->AGCAATAGGATACATACAG
AGCAATAGGATACATACAG->GCAATAGGATACATACAGG
ATGACCACGCTTTAGTACA->TGACCACGCTTTAGTACAT
TGACCACGCTTTAGTACAT->GACCACGCTTTAGTACATC
GTCGCTGTCTTTTGGACCT->TCGCTGTCTTTTGGACCTA
GACTGCCCGGAAACAAAAG->ACTGCCCGGAAACAAAAGA
CCACGCTTTAGTACATCAA->CACGCTTTAGTACATCAAT
CACGCTTTAGTACATCAAT->ACGCTTTAGTACATCAATG
AGAACCATGACTGCCCGGA->GAACCATGACTGCCCGGAA
GAACCATGACTGCCCGGAA->AACCATGACTGCCCGGAAA
TGTACTATACCCCTTATAG->GTACTATACCCCTTATAGC
GTACTATACCCCTTATAGC->TACTATACCCCTTATAGCT
ACTAACTGTCGGGAGGAGA->CTAACTGTCGGGAGGAGAA
GACCCCTAACCTAGGTGTT->ACCCCTAACCTAGGTGTTT
ACCCCTAACCTAGGTGTTT->CCCCTAACCTAGGTGTTTT
CGCTTTAGTACATCAATGG->GCTTTAGTACATCAATGGA
GCTTTAGTACATCAATGGA->CTTTAGTACATCAATGGAA
GCTCCCCGGTAGGAAGCGA->CTCCCCGGTAGGAAGCGAA
CTCCCCGGTAGGAAGCGAA->TCCCCGGTAGGAAGCGAAT
AGCTCCTGCACATCAGCAG->GCTCCTGCACATCAGCAGC
GCTCCTGCACATCAGCAGC->CTCCTGCACATCAGCAGCT
ACGCTTAACATACATCGGA->CGCTTAACATACATCGGAT
CGCTTAACATACATCGGAT->GCTTAACATACATCGGATG
ACGCCCCACGACACCGGGA->CGCCCCACGACACCGGGAA
TCCCGTCAAGTACTCTGAT->CCCGTCAAGTACTCTGATG
CCCGTCAAGTACTCTGATG->CCGTCAAGTACTCTGATGT
CACGGCGCAGATCATTCCG->ACGGCGCAGATCATTCCGC
ACGGCGCAGATCATTCCGC->CGGCGCAGATCATTCCGCT
ACGGCCTGTCGAAGTAACC->CGGCCTGTCGAAGTAACCC
CGGCCTGTCGAAGTAACCC->GGCCTGTCGAAGTAACCCA
GACACCTAACTATCAAAAG->ACACCTAACTATCAAAAGT
ACACCTAACTATCAAAAGT->CACCTAACTATCAAAAGTT
GGGGTCTGGACTCTATTGG->GGGTCTGGACTCTATTGGG
GGGTCTGGACTCTATTGGG->GGTCTGGACTCTATTGGGG
CAGGCCCGATTGCCAGGAA->AGGCCCGATTGCCAGGAAC
AGGCCCGATTGCCAGGAAC->GGCCCGATTGCCAGGAACG
ACCTAATTGTGGGAGGCGA->CCTAATTGTGGGAGGCGAT
CCTAATTGTGGGAGGCGAT->CTAATTGTGGGAGGCGATC
GAGTCAGAGGTACCGATAC->AGTCAGAGGTACCGATACG
AGTCAGAGGTACCGATACG->GTCAGAGGTACCGATACGT
GAACTGTCAACCTAAATGG->AACTGTCAACCTAAATGGA
AACTGTCAACCTAAATGGA->ACTGTCAACCTAAATGGAC
TATTCAGGACCCTCCGAAC->ATTCAGGACCCTCCGAACC
ATTCAGGACCCTCCGAACC->TTCAGGACCCTCCGAACCG
GTTATAACCAAGCCCATCG->TTATAACCAAGCCCATCGC
TTATAACCAAGCCCATCGC->TATAACCAAGCCCATCGCG
ACGATTCTTACCTATGGTT->CGATTCTTACCTATGGTTT
CGATTCTTACCTATGGTTT->GATTCTTACCTATGGTTTT
TCTGCAAAGACCACGGAAG->CTGCAAAGACCACGGAAGC
TTAGGACATGTCGTCGCGC->TAGGACATGTCGTCGCGCC
TAGGACATGTCGTCGCGCC->AGGACATGTCGTCGCGCCG
CTCCGCTCCAGCGCCCGAT->TCCGCTCCAGCGCCCGATC
TCCCATACTCAGCTGTATT->CCCATACTCAGCTGTATTC
CCCATACTCAGCTGTATTC->CCATACTCAGCTGTATTCA
AGTTTTTCAGCCTCCCCGT->GTTTTTCAGCCTCCCCGTC
GTTTTTCAGCCTCCCCGTC->TTTTTCAGCCTCCCCGTCT
TGAGGTCCCCGCAAAATAC->GAGGTCCCCGCAAAATACC
GGCCCTGTAAAATCATCAC->GCCCTGTAAAATCATCACT
CCACGGAAGCCTATAGTAT->CACGGAAGCCTATAGTATC
CACGGAAGCCTATAGTATC->ACGGAAGCCTATAGTATCA
CGGTTCCGTGGGCGAGCTC->GGTTCCGTGGGCGAGCTCC
GGTTCCGTGGGCGAGCTCC->GTTCCGTGGGCGAGCTCCT
TGACGTCGCGTCGAAGGGG->GACGTCGCGTCGAAGGGGT
GACGTCGCGTCGAAGGGGT->ACGTCGCGTCGAAGGGGTC
ACCTAACTATCAAAAGTTG->CCTAACTATCAAAAGTTGC
CCTAACTATCAAAAGTTGC->CTAACTATCAAAAGTTGCT
GGTTATAACCAAGCCCATC->GTTATAACCAAGCCCATCG
AGGACGGTGTATCCGCCCT->GGACGGTGTATCCGCCCTC
GGACGGTGTATCCGCCCTC->GACGGTGTATCCGCCCTCA
CCTTTTGAACCATCTGCAA->CTTTTGAACCATCTGCAAA
TTTACCGTTCCATGTCGAC->TTACCGTTCCATGTCGACC
TTACCGTTCCATGTCGACC->TACCGTTCCATGTCGACCC
ATATTCGTAAGCCGCCATG->TATTCGTAAGCCGCCATGG
AGTTGTTTCGAGTAATTCA->GTTGTTTCGAGTAATTCAC
GTTGTTTCGAGTAATTCAC->TTGTTTCGAGTAATTCACG
GAAGACTTTACTAGCTGAT->AAGACTTTACTAGCTGATG
AAGACTTTACTAGCTGATG->AGACTTTACTAGCTGATGT
ACTCAGCAGAATTCCCGTC->CTCAGCAGAATTCCCGTCA
CTCAGCAGAATTCCCGTCA->TCAGCAGAATTCCCGTCAA
TGCCGGGTACCGGTAGTCA->GCCGGGTACCGGTAGTCAA
GTTAGTTTTTCAGCCTCCC->TTAGTTTTTCAGCCTCCCC
TTAGTTTTTCAGCCTCCCC->TAGTTTTTCAGCCTCCCCG
GCTCCCTCCTACTAAGACA->CTCCCTCCTACTAAGACAC
CTCCCTCCTACTAAGACAC->TCCCTCCTACTAAGACACC
AAAAGTTGCTCAAGGCTCC->AAAGTTGCTCAAGGCTCCC
AAAGTTGCTCAAGGCTCCC->AAGTTGCTCAAGGCTCCCC
ACGGAAGCCTATAGTATCA->CGGAAGCCTATAGTATCAT
CGGAAGCCTATAGTATCAT->GGAAGCCTATAGTATCATT
TAAGCATAAGCAGTGCTAA->AAGCATAAGCAGTGCTAAC
AAGCATAAGCAGTGCTAAC->AGCATAAGCAGTGCTAACG
TCGTACGCATTACTTGTAT->CGTACGCATTACTTGTATC
TTGCTCAAGGCTCCCCGGT->TGCTCAAGGCTCCCCGGTA
TGCTCAAGGCTCCCCGGTA->GCTCAAGGCTCCCCGGTAG
CAGCGACTCAGCAGAATTC->AGCGACTCAGCAGAATTCC
AGCGACTCAGCAGAATTCC->GCGACTCAGCAGAATTCCC
CGACGAGCCAACACCCCTT->GACGAGCCAACACCCCTTC
GATCATCTACGCCATTTAC->ATCATCTACGCCATTTACC
ATCATCTACGCCATTTACC->TCATCTACGCCATTTACCG
CTTTTGAACCATCTGCAAA->TTTTGAACCATCTGCAAAG
TTTTGAACCATCTGCAAAG->TTTGAACCATCTGCAAAGA
CGAGACGGTTCCGTGGGCG->GAGACGGTTCCGTGGGCGA
GAGACGGTTCCGTGGGCGA->AGACGGTTCCGTGGGCGAG
CTATACCCCTTATAGCTAA->TATACCCCTTATAGCTAAT
TTGGATGAAGACTGACTCA->TGGATGAAGACTGACTCAA
TGGATGAAGACTGACTCAA->GGATGAAGACTGACTCAAG
AAGACCACGGAAGCCTATA->AGACCACGGAAGCCTATAG
GGGCCAAGACTATGGTTCG->GGCCAAGACTATGGTTCGC
CGCCTTTGACGGTGCTGGA->GCCTTTGACGGTGCTGGAG
GCCTTTGACGGTGCTGGAG->CCTTTGACGGTGCTGGAGG
TAGTATTCAAGCCACTCCA->AGTATTCAAGCCACTCCAA
AGTATTCAAGCCACTCCAA->GTATTCAAGCCACTCCAAT
GCTGTCCCACATCTAGACC->CTGTCCCACATCTAGACCC
CTGTCCCACATCTAGACCC->TGTCCCACATCTAGACCCC
TAGCCTTGGCTCAGTTCCC->AGCCTTGGCTCAGTTCCCC
CGACGGATCAAGGTCACGG->GACGGATCAAGGTCACGGC
GACGGATCAAGGTCACGGC->ACGGATCAAGGTCACGGCG
GTCGCGTCGAAGGGGTCAG->TCGCGTCGAAGGGGTCAGT
TCGCGTCGAAGGGGTCAGT->CGCGTCGAAGGGGTCAGTT
ACACCGGGAACTGTCAACC->CACCGGGAACTGTCAACCT
CACCGGGAACTGTCAACCT->ACCGGGAACTGTCAACCTA
CCTCCTCAACGTGATTGGT->CTCCTCAACGTGATTGGTA
CTCCTCAACGTGATTGGTA->TCCTCAACGTGATTGGTAC
CGGTGCTGGAGGATATTCG->GGTGCTGGAGGATATTCGT
CTCGCTCTAGACCGTCCTG->TCGCTCTAGACCGTCCTGT
CATTACTTGTATCATCCTG->ATTACTTGTATCATCCTGA
ATTACTTGTATCATCCTGA->TTACTTGTATCATCCTGAT
TCAGATGGGATAGCACCCT->CAGATGGGATAGCACCCTC
CAGATGGGATAGCACCCTC->AGATGGGATAGCACCCTCC
AAATGGACGATGTCGCATC->AATGGACGATGTCGCATCG
AATGGACGATGTCGCATCG->ATGGACGATGTCGCATCGG
AGTATCATTCGTCGCACTG->GTATCATTCGTCGCACTGG
GTATCATTCGTCGCACTGG->TATCATTCGTCGCACTGGA
TCCCAACGAGCTTTTAATG->CCCAACGAGCTTTTAATGT
CCCAACGAGCTTTTAATGT->CCAACGAGCTTTTAATGTT
ATCCCAGGAGAGGCTCGCG->TCCCAGGAGAGGCTCGCGC
TCCCAGGAGAGGCTCGCGC->CCCAGGAGAGGCTCGCGCC
ATGTCTCGCTCTAGACCGT->TGTCTCGCTCTAGACCGTC
TGTCTCGCTCTAGACCGTC->GTCTCGCTCTAGACCGTCC
CGCCATTTACCGTTCCATG->GCCATTTACCGTTCCATGT
GCCATTTACCGTTCCATGT->CCATTTACCGTTCCATGTC
CTGCGCTCTACTTAGGACA->TGCGCTCTACTTAGGACAT
TTTACGGCTTACTAACTGT->TTACGGCTTACTAACTGTC
AGTACATCAATGGAATATG->GTACATCAATGGAATATGC
TGACACCTTATACCACAAT->GACACCTTATACCACAATC
GACACCTTATACCACAATC->ACACCTTATACCACAATCC
CTAGGTGTTTTAGCAATAG->TAGGTGTTTTAGCAATAGG
TTTGGATGAAGACTGACTC->TTGGATGAAGACTGACTCA
TGCGATGCGCTTAGATGCA->GCGATGCGCTTAGATGCAT
TGGCTGCGTCAGTAAGATA->GGCTGCGTCAGTAAGATAA
GGCTGCGTCAGTAAGATAA->GCTGCGTCAGTAAGATAAG
CACACCAACTAACGAGACG->ACACCAACTAACGAGACGG
CCTCCGAATTTCTGCGATC->CTCCGAATTTCTGCGATCC
CTCCGAATTTCTGCGATCC->TCCGAATTTCTGCGATCCG
ACGACGCAACCTGTAAACG->CGACGCAACCTGTAAACGT
GCTGATGTACTATACCCCT->CTGATGTACTATACCCCTT
CTGATGTACTATACCCCTT->TGATGTACTATACCCCTTA
CAGCCTCCCCGTCTCCGCT->AGCCTCCCCGTCTCCGCTC
AGCCTCCCCGTCTCCGCTC->GCCTCCCCGTCTCCGCTCC
TCTGCGATCCGAACGCGAC->CTGCGATCCGAACGCGACG
CTGCGATCCGAACGCGACG->TGCGATCCGAACGCGACGA
AGTCAAAGCCTGGGTACCT->GTCAAAGCCTGGGTACCTT
GTCAAAGCCTGGGTACCTT->TCAAAGCCTGGGTACCTTC
GCTCACACCAACTAACGAG->CTCACACCAACTAACGAGA
GTTAGTATAGTATTCAAGC->TTAGTATAGTATTCAAGCC
GCGACTCAGCAGAATTCCC->CGACTCAGCAGAATTCCCG
CGACTCAGCAGAATTCCCG->GACTCAGCAGAATTCCCGT
AGATAAGTCAAAGCCTGGG->GATAAGTCAAAGCCTGGGT
GATAAGTCAAAGCCTGGGT->ATAAGTCAAAGCCTGGGTA
TATGCCTCGATCAAGACAG->ATGCCTCGATCAAGACAGT
ACTTGTATCATCCTGATAG->CTTGTATCATCCTGATAGT
TCAAGGCTCCCCGGTAGGA->CAAGGCTCCCCGGTAGGAA
CAAGGCTCCCCGGTAGGAA->AAGGCTCCCCGGTAGGAAG
AGGCCCGCGGTTGAGTAAC->GGCCCGCGGTTGAGTAACG
GGCCCGCGGTTGAGTAACG->GCCCGCGGTTGAGTAACGG
TTAAGCATAAGCAGTGCTA->TAAGCATAAGCAGTGCTAA
TATCATTCGTCGCACTGGA->ATCATTCGTCGCACTGGAG
GCGTCGAAGGGGTCAGTTC->CGTCGAAGGGGTCAGTTCG
CGTCGAAGGGGTCAGTTCG->GTCGAAGGGGTCAGTTCGG
CACGACACCGGGAACTGTC->ACGACACCGGGAACTGTCA
ACGACACCGGGAACTGTCA->CGACACCGGGAACTGTCAA
ACCGCCCCAAACTGTGACC->CCGCCCCAAACTGTGACCT
CCGCCCCAAACTGTGACCT->CGCCCCAAACTGTGACCTG
CACCCTCCTCAACGTGATT->ACCCTCCTCAACGTGATTG
ACCCTCCTCAACGTGATTG->CCCTCCTCAACGTGATTGG
GCGGTCTTGCTACCAAGAA->CGGTCTTGCTACCAAGAAC
TTAACCAGTAGACAGTCGC->TAACCAGTAGACAGTCGCA
TAACCAGTAGACAGTCGCA->AACCAGTAGACAGTCGCAG
CGTACGCATTACTTGTATC->GTACGCATTACTTGTATCA
CCCTAGCCTAAATGTCTCA->CCTAGCCTAAATGTCTCAG
CCTAGCCTAAATGTCTCAG->CTAGCCTAAATGTCTCAGT
AGGAGAGGCTCGCGCCTCT->GGAGAGGCTCGCGCCTCTT
GTTTACCTTCAAGAGTAGT->TTTACCTTCAAGAGTAGTC
TTTACCTTCAAGAGTAGTC->TTACCTTCAAGAGTAGTCA
TAACATACATCGGATGACT->AACATACATCGGATGACTC
AACATACATCGGATGACTC->ACATACATCGGATGACTCT
ATGTCGCATCGGGACCTCC->TGTCGCATCGGGACCTCCT
TGTCGCATCGGGACCTCCT->GTCGCATCGGGACCTCCTA
GAATTGAGATACTCCTACT->AATTGAGATACTCCTACTT
GCAAAGACCACGGAAGCCT->CAAAGACCACGGAAGCCTA
AACGACGCAACCTGTAAAC->ACGACGCAACCTGTAAACG
TAATTTTTATTTTGATCAT->AATTTTTATTTTGATCATC
CCAGCGCCCGATCTGTCTA->CAGCGCCCGATCTGTCTAG
CAGCGCCCGATCTGTCTAG->AGCGCCCGATCTGTCTAGA
GCGCCTTTGACGGTGCTGG->CGCCTTTGACGGTGCTGGA
AATGGAATATGCCTCGATC->ATGGAATATGCCTCGATCA
ATGGAATATGCCTCGATCA->TGGAATATGCCTCGATCAA
TAGTTTTTCAGCCTCCCCG->AGTTTTTCAGCCTCCCCGT
AATTTTTATTTTGATCATC->ATTTTTATTTTGATCATCT
ATTTTTATTTTGATCATCT->TTTTTATTTTGATCATCTA
TTAATGTTAGTATAGTATT->TAATGTTAGTATAGTATTC
TAATGTTAGTATAGTATTC->AATGTTAGTATAGTATTCA
GAGGAAGGGATGACCACGC->AGGAAGGGATGACCACGCT
AGGAAGGGATGACCACGCT->GGAAGGGATGACCACGCTT
TGCCGGTTTACCTTCAAGA->GCCGGTTTACCTTCAAGAG
GCCGGTTTACCTTCAAGAG->CCGGTTTACCTTCAAGAGT
CTCGCGCCTCTTATTTTTA->TCGCGCCTCTTATTTTTAG
TCGCGCCTCTTATTTTTAG->CGCGCCTCTTATTTTTAGA
GTACTATATGCAGGGGCAC->TACTATATGCAGGGGCACA
TACTATATGCAGGGGCACA->ACTATATGCAGGGGCACAT
CCGCCATGGCTGCGTCAGT->CGCCATGGCTGCGTCAGTA
CGCCATGGCTGCGTCAGTA->GCCATGGCTGCGTCAGTAA
AGACACCTAACTATCAAAA->GACACCTAACTATCAAAAG
ACCTATGGTTTTACGTCAG->CCTATGGTTTTACGTCAGC
CCTATGGTTTTACGTCAGC->CTATGGTTTTACGTCAGCG
ATCATCACTACTAACTTTA->TCATCACTACTAACTTTAC
TCATCACTACTAACTTTAC->CATCACTACTAACTTTACG
CATCCTGATAGTCAACCTC->ATCCTGATAGTCAACCTCC
TCAAAGCCTGGGTACCTTC->CAAAGCCTGGGTACCTTCC
CAAAGCCTGGGTACCTTCC->AAAGCCTGGGTACCTTCCC
TGCTGAAGACTTTACTAGC->GCTGAAGACTTTACTAGCT
GCTACTGAGAAAAGCCGTT->CTACTGAGAAAAGCCGTTC
CTACTGAGAAAAGCCGTTC->TACTGAGAAAAGCCGTTCA
TACAGCGCCGTATTCAGGA->ACAGCGCCGTATTCAGGAC
ACAGCGCCGTATTCAGGAC->CAGCGCCGTATTCAGGACC
CGCGCCTTTGACGGTGCTG->GCGCCTTTGACGGTGCTGG
GTAAGCCGCCATGGCTGCG->TAAGCCGCCATGGCTGCGT
TAAGCCGCCATGGCTGCGT->AAGCCGCCATGGCTGCGTC
TTAGCAATAGGATACATAC->TAGCAATAGGATACATACA
TCAGTTCGGCCTTTTGAAC->CAGTTCGGCCTTTTGAACC
CAGTTCGGCCTTTTGAACC->AGTTCGGCCTTTTGAACCA
GGTTAAAGTGGAGTCAGAG->GTTAAAGTGGAGTCAGAGG
GTTAAAGTGGAGTCAGAGG->TTAAAGTGGAGTCAGAGGT
CTTGCTACCAAGAACCAAC->TTGCTACCAAGAACCAACA
CTCTGATGTTCGCAAAATG->TCTGATGTTCGCAAAATGG
TCTGATGTTCGCAAAATGG->CTGATGTTCGCAAAATGGA
GCTTAACATACATCGGATG->CTTAACATACATCGGATGA
TCTCAGTATGAGGTCCCCG->CTCAGTATGAGGTCCCCGC
CTCAGTATGAGGTCCCCGC->TCAGTATGAGGTCCCCGCA
CTATCAAAAGTTGCTCAAG->TATCAAAAGTTGCTCAAGG
CTGGGTACCTTCCGATACA->TGGGTACCTTCCGATACAG
CGACCCACGACGGATCAAG->GACCCACGACGGATCAAGG
GACCCACGACGGATCAAGG->ACCCACGACGGATCAAGGT
GCGACGAGCCAACACCCCT->CGACGAGCCAACACCCCTT
CGCTCCCTCCTACTAAGAC->GCTCCCTCCTACTAAGACA
TCAAAAGTTGCTCAAGGCT->CAAAAGTTGCTCAAGGCTC
CAAAAGTTGCTCAAGGCTC->AAAAGTTGCTCAAGGCTCC
ACTTCACGGTGCGATGCGC->CTTCACGGTGCGATGCGCT
GTTCGCAAAATGGACTCGC->TTCGCAAAATGGACTCGCT
CATTCGTCGCACTGGAGCA->ATTCGTCGCACTGGAGCAG
ACCGCTCTCTAGGGTTATA->CCGCTCTCTAGGGTTATAA
CCGCTCTCTAGGGTTATAA->CGCTCTCTAGGGTTATAAC
TTTACTAGCTGATGTACTA->TTACTAGCTGATGTACTAT
TCCCTCCTACTAAGACACC->CCCTCCTACTAAGACACCT
CCATAACGAACGCGTATTC->CATAACGAACGCGTATTCA
CATAACGAACGCGTATTCA->ATAACGAACGCGTATTCAG
CAAGAACCAACACAACGAC->AAGAACCAACACAACGACG
ATAAGTCAAAGCCTGGGTA->TAAGTCAAAGCCTGGGTAC
AGAAAAGCCGTTCAAAAAG->GAAAAGCCGTTCAAAAAGT
GAAAAGCCGTTCAAAAAGT->AAAAGCCGTTCAAAAAGTA
TGAAAGCCTGGGTACCTTC->GAAAGCCTGGGTACCTTCC
TCTGTCTAGAATAAAGCCT->CTGTCTAGAATAAAGCCTG
AATGTCTCGCTCTAGACCG->ATGTCTCGCTCTAGACCGT
CGCTCCAGCGCCCGATCTG->GCTCCAGCGCCCGATCTGT
GCTCCAGCGCCCGATCTGT->CTCCAGCGCCCGATCTGTC
TAGCTCACACCAACTAACG->AGCTCACACCAACTAACGA
AGCTCACACCAACTAACGA->GCTCACACCAACTAACGAG
ACCACGCTTTAGTACATCA->CCACGCTTTAGTACATCAA
ATCTGTCTAGAATAAAGCC->TCTGTCTAGAATAAAGCCT
GCACTTCACGGTGCGATGC->CACTTCACGGTGCGATGCG
CACTTCACGGTGCGATGCG->ACTTCACGGTGCGATGCGC
GATGTCGCATCGGGACCTC->ATGTCGCATCGGGACCTCC
AGCATAAGCAGTGCTAACG->GCATAAGCAGTGCTAACGC
GCATAAGCAGTGCTAACGC->CATAAGCAGTGCTAACGCC
TCCCCGGTAGGAAGCGAAT->CCCCGGTAGGAAGCGAATT
CCCCGGTAGGAAGCGAATT->CCCGGTAGGAAGCGAATTA
CAAGACAGTTGTTTCGAGT->AAGACAGTTGTTTCGAGTA
TCGTCGCGCCGAGGGCGCA->CGTCGCGCCGAGGGCGCAG
TTTCTGCGATCCGAACGCG->TTCTGCGATCCGAACGCGA
TTCTGCGATCCGAACGCGA->TCTGCGATCCGAACGCGAC
CCGATTGCCAGGAACGATG->CGATTGCCAGGAACGATGA
CATGTCGACCCACGACGGA->ATGTCGACCCACGACGGAT
AAGAGTAGTCACCGCTCTC->AGAGTAGTCACCGCTCTCT
CTAGCTCACACCAACTAAC->TAGCTCACACCAACTAACG
CGATGTCGCATCGGGACCT->GATGTCGCATCGGGACCTC
TTCAGGCCGGGACGCGTTA->TCAGGCCGGGACGCGTTAT
TCAGGCCGGGACGCGTTAT->CAGGCCGGGACGCGTTATA
GGTCTGGACTCTATTGGGG->GTCTGGACTCTATTGGGGC
GTCTGGACTCTATTGGGGC->TCTGGACTCTATTGGGGCT
TCTCCGGGTAAATCCCAGG->CTCCGGGTAAATCCCAGGA
CTAACTTTACGGCTTACTA->TAACTTTACGGCTTACTAA
CCTGGGTACCTTCCTCCAT->CTGGGTACCTTCCTCCATC
AAAGATGCGTGGCAGCATC->AAGATGCGTGGCAGCATCC
ATGGGATAGCACCCTCCTC->TGGGATAGCACCCTCCTCA
TGGGATAGCACCCTCCTCA->GGGATAGCACCCTCCTCAA
GCCGGGACGCGTTATACCT->CCGGGACGCGTTATACCTA
CCGGGACGCGTTATACCTA->CGGGACGCGTTATACCTAT
GGCCCTAGCTCACACCAAC->GCCCTAGCTCACACCAACT
GGGCGAGCTCCTGCACATC->GGCGAGCTCCTGCACATCA
GGCGAGCTCCTGCACATCA->GCGAGCTCCTGCACATCAG
TACAGGAGTAAAAGCCTGG->ACAGGAGTAAAAGCCTGGG
ACAGGAGTAAAAGCCTGGG->CAGGAGTAAAAGCCTGGGT
TACTGAGAAAAGCCGTTCA->ACTGAGAAAAGCCGTTCAA
CTGACTCAAGGGGTCTGGA->TGACTCAAGGGGTCTGGAC
TCTCCGCTCCAGCGCCCGA->CTCCGCTCCAGCGCCCGAT
AACCAAGCCCATCGCGCCT->ACCAAGCCCATCGCGCCTT
ACCAAGCCCATCGCGCCTT->CCAAGCCCATCGCGCCTTT
GTCTAGAATAAAGCCTGGG->TCTAGAATAAAGCCTGGGT
TTGGCTCAGTTCCCCAACG->TGGCTCAGTTCCCCAACGA
TGGCTCAGTTCCCCAACGA->GGCTCAGTTCCCCAACGAG
TCCTCAACGTGATTGGTAC->CCTCAACGTGATTGGTACT
CCTCAACGTGATTGGTACT->CTCAACGTGATTGGTACTA
GACCTCCTATTACAATGTC->ACCTCCTATTACAATGTCT
TCAAGTACTCTGATGTTCG->CAAGTACTCTGATGTTCGC
CAAGTACTCTGATGTTCGC->AAGTACTCTGATGTTCGCA
TTCACGTCACCGGGGCGAA->TCACGTCACCGGGGCGAAT
TCACGTCACCGGGGCGAAT->CACGTCACCGGGGCGAATA
CTACTTGAAAGCCTGGGTA->TACTTGAAAGCCTGGGTAC
TACTTGAAAGCCTGGGTAC->ACTTGAAAGCCTGGGTACC
CCATCTGCAAAGACCACGG->CATCTGCAAAGACCACGGA
TACTTAGGACATGTCGTCG->ACTTAGGACATGTCGTCGC
AACGAGAGGACGGTGTATC->ACGAGAGGACGGTGTATCC
ACGAGAGGACGGTGTATCC->CGAGAGGACGGTGTATCCG
GTATCATCCTGATAGTCAA->TATCATCCTGATAGTCAAC
GCAGTGCTAACGCCCCACG->CAGTGCTAACGCCCCACGA
CAGTGCTAACGCCCCACGA->AGTGCTAACGCCCCACGAC
TGGTTCGCTGTTACTGATC->GGTTCGCTGTTACTGATCA
TTATTTTGATCATCTACGC->TATTTTGATCATCTACGCC
TCCTTGACGTCGCGTCGAA->CCTTGACGTCGCGTCGAAG
CCTTGACGTCGCGTCGAAG->CTTGACGTCGCGTCGAAGG
ACCATCTGCAAAGACCACG->CCATCTGCAAAGACCACGG
AGAGGTACCGATACGTGCT->GAGGTACCGATACGTGCTG
TCTATTGGGGCTAACCTGG->CTATTGGGGCTAACCTGGC
CTATTGGGGCTAACCTGGC->TATTGGGGCTAACCTGGCG
CACGCTACTGAGAAAAGCC->ACGCTACTGAGAAAAGCCG
ACGCTACTGAGAAAAGCCG->CGCTACTGAGAAAAGCCGT
CAACACAACGACGCAACCT->AACACAACGACGCAACCTG
AACACAACGACGCAACCTG->ACACAACGACGCAACCTGT
ATAGTCAACCTCCACGCTG->TAGTCAACCTCCACGCTGT
TAGTCAACCTCCACGCTGT->AGTCAACCTCCACGCTGTC
AGACAGTTGTTTCGAGTAA->GACAGTTGTTTCGAGTAAT
GACAGTTGTTTCGAGTAAT->ACAGTTGTTTCGAGTAATT
CAGCATCCCAACGAGCTTT->AGCATCCCAACGAGCTTTT
AGCATCCCAACGAGCTTTT->GCATCCCAACGAGCTTTTA
AGCCTAAATGTCTCAGTAT->GCCTAAATGTCTCAGTATG
GCGAGTACCCTGCGCTCTA->CGAGTACCCTGCGCTCTAC
CGAGTACCCTGCGCTCTAC->GAGTACCCTGCGCTCTACT
GCGATCCTGTGGCCCTAGC->CGATCCTGTGGCCCTAGCT
CGATCCTGTGGCCCTAGCT->GATCCTGTGGCCCTAGCTC
GCGTCAGTAAGATAAGTCA->CGTCAGTAAGATAAGTCAA
CGTCAGTAAGATAAGTCAA->GTCAGTAAGATAAGTCAAA
CTGATGTTCGCAAAATGGA->TGATGTTCGCAAAATGGAC
TGATGTTCGCAAAATGGAC->GATGTTCGCAAAATGGACT
ATTTATTCAATAACGTAAG->TTTATTCAATAACGTAAGA
TTTATTCAATAACGTAAGA->TTATTCAATAACGTAAGAT
ATCGGACGTAGCACGTGGG->TCGGACGTAGCACGTGGGC
AGGGATTTCTTGGGAAGAT->GGGATTTCTTGGGAAGATG
GGGATTTCTTGGGAAGATG->GGATTTCTTGGGAAGATGT
ATTTTTTATCTGGACGCTT->TTTTTTATCTGGACGCTTA
AACGTGATTGGTACTATAT->ACGTGATTGGTACTATATG
GTAACGGCCTGTCGAAGTA->TAACGGCCTGTCGAAGTAA
CGCCCTCACGCTACTGAGA->GCCCTCACGCTACTGAGAA
GATCATTCCGCTGCACAGG->ATCATTCCGCTGCACAGGC
ATCATTCCGCTGCACAGGC->TCATTCCGCTGCACAGGCC
GCGTATTCAGGACCCTCCG->CGTATTCAGGACCCTCCGA
GTCGCGCCGAGGGCGCAGT->TCGCGCCGAGGGCGCAGTA
TCGCGCCGAGGGCGCAGTA->CGCGCCGAGGGCGCAGTAG
CGCTCTCTAGGGTTATAAC->GCTCTCTAGGGTTATAACC
GCTCTCTAGGGTTATAACC->CTCTCTAGGGTTATAACCA
TGATGTACTATACCCCTTA->GATGTACTATACCCCTTAT
AATTTATTCAATAACGTAA->ATTTATTCAATAACGTAAG
GGACCCTCCGAATTTCTGC->GACCCTCCGAATTTCTGCG
GACCCTCCGAATTTCTGCG->ACCCTCCGAATTTCTGCGA
TCGGGACCTCCTATTACAA->CGGGACCTCCTATTACAAT
CGGGACCTCCTATTACAAT->GGGACCTCCTATTACAATG
TGGACGCTTAACATACATC->GGACGCTTAACATACATCG
GGACGCTTAACATACATCG->GACGCTTAACATACATCGG
GTTCCATGTCGACCCACGA->TTCCATGTCGACCCACGAC
TTCCATGTCGACCCACGAC->TCCATGTCGACCCACGACG
GCCGAGGGCGCAGTAGTGC->CCGAGGGCGCAGTAGTGCC
ACTTAGGACATGTCGTCGC->CTTAGGACATGTCGTCGCG
CGTCAGCGACTCAGCAGAA->GTCAGCGACTCAGCAGAAT
TACCTTCCTCCATCCCGAT->ACCTTCCTCCATCCCGATG
CCGAATTTCTGCGATCCGA->CGAATTTCTGCGATCCGAA
CCGAACGCGACGAGCCAAC->CGAACGCGACGAGCCAACA
CGAACGCGACGAGCCAACA->GAACGCGACGAGCCAACAC
CGTCCTTGACGTCGCGTCG->GTCCTTGACGTCGCGTCGA
GTCCTTGACGTCGCGTCGA->TCCTTGACGTCGCGTCGAA
TAAAGCCTGGGTACCTTCC->AAAGCCTGGGTACCTTCCT
CGTTGGGAATGCAAACGTC->GTTGGGAATGCAAACGTCG
GTTGGGAATGCAAACGTCG->TTGGGAATGCAAACGTCGC
GGTGTTTTAGCAATAGGAT->GTGTTTTAGCAATAGGATA
TCTAGAATAAAGCCTGGGT->CTAGAATAAAGCCTGGGTA
CACTCCAATTTATTCAATA->ACTCCAATTTATTCAATAA
ACTCCAATTTATTCAATAA->CTCCAATTTATTCAATAAC
TCCGCCCTCACGCTACTGA->CCGCCCTCACGCTACTGAG
CACCAACTAACGAGACGGT->ACCAACTAACGAGACGGTT
ACCAACTAACGAGACGGTT->CCAACTAACGAGACGGTTC
GACTATGGTTCGCTGTTAC->ACTATGGTTCGCTGTTACT
TATTCGTAAGCCGCCATGG->ATTCGTAAGCCGCCATGGC
TTAAAGTGGAGTCAGAGGT->TAAAGTGGAGTCAGAGGTA
CGAGTAATTCACGTCACCG->GAGTAATTCACGTCACCGG
GTAAGATAAGTCAAAGCCT->TAAGATAAGTCAAAGCCTG
TATTTTGATCATCTACGCC->ATTTTGATCATCTACGCCA
ATTTTGATCATCTACGCCA->TTTTGATCATCTACGCCAT
ATAGCTAATGCGAGTACCC->TAGCTAATGCGAGTACCCT
TAGCTAATGCGAGTACCCT->AGCTAATGCGAGTACCCTG
CGATGATTTTGGATGAAGA->GATGATTTTGGATGAAGAC
GATGATTTTGGATGAAGAC->ATGATTTTGGATGAAGACT
ATACTCAGCTGTATTCAGG->TACTCAGCTGTATTCAGGA
AAAATCATCACTACTAACT->AAATCATCACTACTAACTT
CTTCCATAACGAACGCGTA->TTCCATAACGAACGCGTAT
TCCCCGCAAAATACCGGGA->CCCCGCAAAATACCGGGAA
AGCTTTTAATGTTAGTATA->GCTTTTAATGTTAGTATAG
GCTTTTAATGTTAGTATAG->CTTTTAATGTTAGTATAGT
GGGATTTAGCCTTGGCTCA->GGATTTAGCCTTGGCTCAG
TACCTTCCATAACGAACGC->ACCTTCCATAACGAACGCG
ACCTTCCATAACGAACGCG->CCTTCCATAACGAACGCGT
TCGAAGGGGTCAGTTCGGC->CGAAGGGGTCAGTTCGGCC
CGAAGGGGTCAGTTCGGCC->GAAGGGGTCAGTTCGGCCT
GCTGCACAGGCCCGATTGC->CTGCACAGGCCCGATTGCC
CCTCCGAACCGCCCCAAAC->CTCCGAACCGCCCCAAACT
CTCCGAACCGCCCCAAACT->TCCGAACCGCCCCAAACTG
TAGGAAGCGAATTATAGTA->AGGAAGCGAATTATAGTAG
AGGAAGCGAATTATAGTAG->GGAAGCGAATTATAGTAGA
ACTCTGATGTTCGCAAAAT->CTCTGATGTTCGCAAAATG
ACTATACCCCTTATAGCTA->CTATACCCCTTATAGCTAA
ACACCAACTAACGAGACGG->CACCAACTAACGAGACGGT
CCTTGGCTCAGTTCCCCAA->CTTGGCTCAGTTCCCCAAC
CTTGGCTCAGTTCCCCAAC->TTGGCTCAGTTCCCCAACG
CCGGTTTACCTTCAAGAGT->CGGTTTACCTTCAAGAGTA
CGTCGCGCCGAGGGCGCAG->GTCGCGCCGAGGGCGCAGT
AAGCCGCCATGGCTGCGTC->AGCCGCCATGGCTGCGTCA
AGCCGCCATGGCTGCGTCA->GCCGCCATGGCTGCGTCAG
CCCGGTAGGAAGCGAATTA->CCGGTAGGAAGCGAATTAT
TTCCCATACTCAGCTGTAT->TCCCATACTCAGCTGTATT
GTCAGTTCGGCCTTTTGAA->TCAGTTCGGCCTTTTGAAC
ACAGTTGTTTCGAGTAATT->CAGTTGTTTCGAGTAATTC
GATGAAGACTGACTCAAGG->ATGAAGACTGACTCAAGGG
GCTAACGCCCCACGACACC->CTAACGCCCCACGACACCG
CTAACGCCCCACGACACCG->TAACGCCCCACGACACCGG
AGACAGTCGCAGCTCTGAG->GACAGTCGCAGCTCTGAGG
GACAGTCGCAGCTCTGAGG->ACAGTCGCAGCTCTGAGGA
AAGTTGCTCAAGGCTCCCC->AGTTGCTCAAGGCTCCCCG
AACCTAGGTGTTTTAGCAA->ACCTAGGTGTTTTAGCAAT
ACCTAGGTGTTTTAGCAAT->CCTAGGTGTTTTAGCAATA
ACAAAAGATGCGTGGCAGC->CAAAAGATGCGTGGCAGCA
GACGCGTTATACCTATTCG->ACGCGTTATACCTATTCGT
GGACATGTCGTCGCGCCGA->GACATGTCGTCGCGCCGAG
GACATGTCGTCGCGCCGAG->ACATGTCGTCGCGCCGAGG
TTGACGGTGCTGGAGGATA->TGACGGTGCTGGAGGATAT
TGACGGTGCTGGAGGATAT->GACGGTGCTGGAGGATATT
ATCATTAAGCATAAGCAGT->TCATTAAGCATAAGCAGTG
AGAGTAGTCACCGCTCTCT->GAGTAGTCACCGCTCTCTA
CGCGGTTGAGTAACGGCCT->GCGGTTGAGTAACGGCCTG
GCGGTTGAGTAACGGCCTG->CGGTTGAGTAACGGCCTGT
CCAGTAGACAGTCGCAGCT->CAGTAGACAGTCGCAGCTC
CAGTAGACAGTCGCAGCTC->AGTAGACAGTCGCAGCTCT
AACTAACGAGACGGTTCCG->ACTAACGAGACGGTTCCGT
ACTAACGAGACGGTTCCGT->CTAACGAGACGGTTCCGTG
GCTCAAGGCTCCCCGGTAG->CTCAAGGCTCCCCGGTAGG
CTCAAGGCTCCCCGGTAGG->TCAAGGCTCCCCGGTAGGA
TACTAACTGTCGGGAGGAG->ACTAACTGTCGGGAGGAGA
GATAGTCAACCTCCACGCT->ATAGTCAACCTCCACGCTG
TGTGACCTGCACTTCACGG->GTGACCTGCACTTCACGGT
GTGACCTGCACTTCACGGT->TGACCTGCACTTCACGGTG
CCTGTAAAATCATCACTAC->CTGTAAAATCATCACTACT
CTGTAAAATCATCACTACT->TGTAAAATCATCACTACTA
AGCCTGGGTACCTTCCGAT->GCCTGGGTACCTTCCGATA
GCCTGGGTACCTTCCGATA->CCTGGGTACCTTCCGATAC
GCACAGGCCCGATTGCCAG->CACAGGCCCGATTGCCAGG
CACAGGCCCGATTGCCAGG->ACAGGCCCGATTGCCAGGA
TTGATTTTATTCTTGACAC->TGATTTTATTCTTGACACC
TGATTTTATTCTTGACACC->GATTTTATTCTTGACACCT
GACGATGTCGCATCGGGAC->ACGATGTCGCATCGGGACC
TCGTTGGGAATGCAAACGT->CGTTGGGAATGCAAACGTC
CCCCGTCTCCGCTCCAGCG->CCCGTCTCCGCTCCAGCGC
CCCGTCTCCGCTCCAGCGC->CCGTCTCCGCTCCAGCGCC
CGATTGCCAGGAACGATGA->GATTGCCAGGAACGATGAT
ATAAGCAGTGCTAACGCCC->TAAGCAGTGCTAACGCCCC
TAAGCAGTGCTAACGCCCC->AAGCAGTGCTAACGCCCCA
CTATTCGTTGGGAATGCAA->TATTCGTTGGGAATGCAAA
TATTCGTTGGGAATGCAAA->ATTCGTTGGGAATGCAAAC
GTTCAAAAAGTATGATAGA->TTCAAAAAGTATGATAGAC
TTCAAAAAGTATGATAGAC->TCAAAAAGTATGATAGACG
CTGATCAGTTTTGAAACGA->TGATCAGTTTTGAAACGAG
TCCGCTGCACAGGCCCGAT->CCGCTGCACAGGCCCGATT
AGGTCCCCGCAAAATACCG->GGTCCCCGCAAAATACCGG
ATCAAGGTCACGGCGCAGA->TCAAGGTCACGGCGCAGAT
CTTCCCATACTCAGCTGTA->TTCCCATACTCAGCTGTAT
CACATCTAGACCCCTAACC->ACATCTAGACCCCTAACCT
ACATCTAGACCCCTAACCT->CATCTAGACCCCTAACCTA
AGAACCAACACAACGACGC->GAACCAACACAACGACGCA
GAACCAACACAACGACGCA->AACCAACACAACGACGCAA
CAGAGGTACCGATACGTGC->AGAGGTACCGATACGTGCT
TCAGTATGAGGTCCCCGCA->CAGTATGAGGTCCCCGCAA
GGACTATTCGTACGCATTA->GACTATTCGTACGCATTAC
CCAAGCCCATCGCGCCTTT->CAAGCCCATCGCGCCTTTG
CAAGCCCATCGCGCCTTTG->AAGCCCATCGCGCCTTTGA
CCTTATAGCTAATGCGAGT->CTTATAGCTAATGCGAGTA
CTTATAGCTAATGCGAGTA->TTATAGCTAATGCGAGTAC
TACCTTCCCATACTCAGCT->ACCTTCCCATACTCAGCTG
CCTCACGCTACTGAGAAAA->CTCACGCTACTGAGAAAAG
CAGCTGGGATTTAGCCTTG->AGCTGGGATTTAGCCTTGG
AGCTGGGATTTAGCCTTGG->GCTGGGATTTAGCCTTGGC
CCTGGGTACCTTCCGATAC->CTGGGTACCTTCCGATACA
TGCGCTTAGATGCATCATT->GCGCTTAGATGCATCATTA
GCGCTTAGATGCATCATTA->CGCTTAGATGCATCATTAA
GGGTTATAACCAAGCCCAT->GGTTATAACCAAGCCCATC
AATTCACGTCACCGGGGCG->ATTCACGTCACCGGGGCGA
ATTCACGTCACCGGGGCGA->TTCACGTCACCGGGGCGAA
TTTCAGGCCGGGACGCGTT->TTCAGGCCGGGACGCGTTA
CCCTCCTCAACGTGATTGG->CCTCCTCAACGTGATTGGT
GTGTATCCGCCCTCACGCT->TGTATCCGCCCTCACGCTA
TGTATCCGCCCTCACGCTA->GTATCCGCCCTCACGCTAC
ATCACTACTAACTTTACGG->TCACTACTAACTTTACGGC
CGCACTGGAGCAGGTTAAA->GCACTGGAGCAGGTTAAAG
CTCAACGTGATTGGTACTA->TCAACGTGATTGGTACTAT
CTCCAGCGCCCGATCTGTC->TCCAGCGCCCGATCTGTCT
TCCAGCGCCCGATCTGTCT->CCAGCGCCCGATCTGTCTA
CATAAGCAGTGCTAACGCC->ATAAGCAGTGCTAACGCCC
CCTATTCGTTGGGAATGCA->CTATTCGTTGGGAATGCAA
CCCCGCAAAATACCGGGAA->CCCGCAAAATACCGGGAAT
AGGGGTCAGTTCGGCCTTT->GGGGTCAGTTCGGCCTTTT
CGAAGTAACCCACTCAGAT->GAAGTAACCCACTCAGATG
GAAGTAACCCACTCAGATG->AAGTAACCCACTCAGATGG
TACTATACCCCTTATAGCT->ACTATACCCCTTATAGCTA
ATTCAGGACCCTCCGAAGT->TTCAGGACCCTCCGAAGTT
TTCAGGACCCTCCGAAGTT->TCAGGACCCTCCGAAGTTC
GACTCAGCAGAATTCCCGT->ACTCAGCAGAATTCCCGTC
CTAGCCTAAATGTCTCAGT->TAGCCTAAATGTCTCAGTA
AGTAGACAGTCGCAGCTCT->GTAGACAGTCGCAGCTCTG
GTAGACAGTCGCAGCTCTG->TAGACAGTCGCAGCTCTGA
AATTTCTGCGATCCGAACG->ATTTCTGCGATCCGAACGC
GGAGAGGCTCGCGCCTCTT->GAGAGGCTCGCGCCTCTTA
TAAAATCATCACTACTAAC->AAAATCATCACTACTAACT
ACGGTTCCGTGGGCGAGCT->CGGTTCCGTGGGCGAGCTC
TCGCTGTTACTGATCAGTT->CGCTGTTACTGATCAGTTT
CGCTGTTACTGATCAGTTT->GCTGTTACTGATCAGTTTT
TAGATGCATCATTAAGCAT->AGATGCATCATTAAGCATA
AGATGCATCATTAAGCATA->GATGCATCATTAAGCATAA
CTATTCGTACGCATTACTT->TATTCGTACGCATTACTTG
TGTAAACGTCCTTGACGTC->GTAAACGTCCTTGACGTCG
GTAAACGTCCTTGACGTCG->TAAACGTCCTTGACGTCGC
GGGCGCAGTAGTGCCGGGT->GGCGCAGTAGTGCCGGGTA
GGCGCAGTAGTGCCGGGTA->GCGCAGTAGTGCCGGGTAC
ACCCTGCGCTCTACTTAGG->CCCTGCGCTCTACTTAGGA
GTGTTTTAGCAATAGGATA->TGTTTTAGCAATAGGATAC
CCACATCTAGACCCCTAAC->CACATCTAGACCCCTAACC
AAACTGTGACCTGCACTTC->AACTGTGACCTGCACTTCA
TACATACAGGAGTAAAAGC->ACATACAGGAGTAAAAGCC
ACATACAGGAGTAAAAGCC->CATACAGGAGTAAAAGCCT
GGAACGATGATTTTGGATG->GAACGATGATTTTGGATGA
CAACCTAAATGGACGATGT->AACCTAAATGGACGATGTC
AACCTAAATGGACGATGTC->ACCTAAATGGACGATGTCG
ACATAATTTTTATTTTGAT->CATAATTTTTATTTTGATC
CTCACGCTACTGAGAAAAG->TCACGCTACTGAGAAAAGC
GAGTACCCTGCGCTCTACT->AGTACCCTGCGCTCTACTT
AGTACCCTGCGCTCTACTT->GTACCCTGCGCTCTACTTA
CAGCTGTATTCAGGACCCT->AGCTGTATTCAGGACCCTC
TAGACAGTCGCAGCTCTGA->AGACAGTCGCAGCTCTGAG
AACCATCTGCAAAGACCAC->ACCATCTGCAAAGACCACG
GCAGCTGGGATTTAGCCTT->CAGCTGGGATTTAGCCTTG
AGCGCCCGATCTGTCTAGA->GCGCCCGATCTGTCTAGAA
AGCCACTCCAATTTATTCA->GCCACTCCAATTTATTCAA
TCCGAATTTCTGCGATCCG->CCGAATTTCTGCGATCCGA
ACGATGTCGCATCGGGACC->CGATGTCGCATCGGGACCT
ACGTGCTGAAGACTTTACT->CGTGCTGAAGACTTTACTA
TTATTCAATAACGTAAGAT->TATTCAATAACGTAAGATC
TATTCAATAACGTAAGATC->ATTCAATAACGTAAGATCT
GAGCTCCTGCACATCAGCA->AGCTCCTGCACATCAGCAG
GGCGAATATTTTTTATCTG->GCGAATATTTTTTATCTGG
GGCGGTCTTGCTACCAAGA->GCGGTCTTGCTACCAAGAA
AATGCGAGTACCCTGCGCT->ATGCGAGTACCCTGCGCTC
ATGGTTTTACGTCAGCGAC->TGGTTTTACGTCAGCGACT
GCTTTAACCAGTAGACAGT->CTTTAACCAGTAGACAGTC
CCCACTCAGATGGGATAGC->CCACTCAGATGGGATAGCA
CTTTTAATGTTAGTATAGT->TTTTAATGTTAGTATAGTA
ATTCAATAACGTAAGATCT->TTCAATAACGTAAGATCTC
TTCAATAACGTAAGATCTC->TCAATAACGTAAGATCTCC
TCCTACTTGAAAGCCTGGG->CCTACTTGAAAGCCTGGGT
CCTACTTGAAAGCCTGGGT->CTACTTGAAAGCCTGGGTA
ATCCTGATAGTCAACCTCC->TCCTGATAGTCAACCTCCA
CGTTCAAAAAGTATGATAG->GTTCAAAAAGTATGATAGA
CGTAAGATCTCCGGGTAAA->GTAAGATCTCCGGGTAAAT
GTAAGATCTCCGGGTAAAT->TAAGATCTCCGGGTAAATC
CGCCCGATCTGTCTAGAAT->GCCCGATCTGTCTAGAATA
GCCCGATCTGTCTAGAATA->CCCGATCTGTCTAGAATAA
TCCGAACCGCCCCAAACTG->CCGAACCGCCCCAAACTGT
GCTGTTACTGATCAGTTTT->CTGTTACTGATCAGTTTTG
CTGTTACTGATCAGTTTTG->TGTTACTGATCAGTTTTGA
TGCTAACGCCCCACGACAC->GCTAACGCCCCACGACACC
TGGAGGATATTCGTAAGCC->GGAGGATATTCGTAAGCCG
GGAGGATATTCGTAAGCCG->GAGGATATTCGTAAGCCGC
GAATATTTTTTATCTGGAC->AATATTTTTTATCTGGACG
AATATTTTTTATCTGGACG->ATATTTTTTATCTGGACGC
CCGTCTCCGCTCCAGCGCC->CGTCTCCGCTCCAGCGCCC
CGTCTCCGCTCCAGCGCCC->GTCTCCGCTCCAGCGCCCG
GTCGCATCGGGACCTCCTA->TCGCATCGGGACCTCCTAT
AATTGAGATACTCCTACTT->ATTGAGATACTCCTACTTG
ATTGAGATACTCCTACTTG->TTGAGATACTCCTACTTGA
CCGAAGTTCATCGGACGTA->CGAAGTTCATCGGACGTAG
TGTTACTGATCAGTTTTGA->GTTACTGATCAGTTTTGAA
CACGTCACCGGGGCGAATA->ACGTCACCGGGGCGAATAT
ACGTCACCGGGGCGAATAT->CGTCACCGGGGCGAATATT
ACTCTATTGGGGCTAACCT->CTCTATTGGGGCTAACCTG
CTCTATTGGGGCTAACCTG->TCTATTGGGGCTAACCTGG
GTACGCATTACTTGTATCA->TACGCATTACTTGTATCAT
TACGCATTACTTGTATCAT->ACGCATTACTTGTATCATC
TCAGCAGAATTCCCGTCAA->CAGCAGAATTCCCGTCAAG
TTTTAGAATTGAGATACTC->TTTAGAATTGAGATACTCC
AATGCAAACGTCGCTGTCT->ATGCAAACGTCGCTGTCTT
ATGCAAACGTCGCTGTCTT->TGCAAACGTCGCTGTCTTT
CTTGACACCTTATACCACA->TTGACACCTTATACCACAA
TTGACACCTTATACCACAA->TGACACCTTATACCACAAT
GAGAGGCTCGCGCCTCTTA->AGAGGCTCGCGCCTCTTAT
CCGATCTGTCTAGAATAAA->CGATCTGTCTAGAATAAAG
CGATCTGTCTAGAATAAAG->GATCTGTCTAGAATAAAGC
CTGTGACCTGCACTTCACG->TGTGACCTGCACTTCACGG
TCTTGGGAAGATGTCACGA->CTTGGGAAGATGTCACGAT
CTTGGGAAGATGTCACGAT->TTGGGAAGATGTCACGATT
TCTTGACACCTTATACCAC->CTTGACACCTTATACCACA
AACCCACTCAGATGGGATA->ACCCACTCAGATGGGATAG
ACCCACTCAGATGGGATAG->CCCACTCAGATGGGATAGC
TGGGATGTTGATTTTATTC->GGGATGTTGATTTTATTCT
GGGATGTTGATTTTATTCT->GGATGTTGATTTTATTCTT
CCCCACGACACCGGGAACT->CCCACGACACCGGGAACTG
CCCACGACACCGGGAACTG->CCACGACACCGGGAACTGT
ACAATCCCTAGCCTAAATG->CAATCCCTAGCCTAAATGT
CAATCCCTAGCCTAAATGT->AATCCCTAGCCTAAATGTC
GGCGGCTGGGATGTTGATT->GCGGCTGGGATGTTGATTT
GCGGCTGGGATGTTGATTT->CGGCTGGGATGTTGATTTT
TTACGTCAGCGACTCAGCA->TACGTCAGCGACTCAGCAG
TACGTCAGCGACTCAGCAG->ACGTCAGCGACTCAGCAGA
GCTGCGTCAGTAAGATAAG->CTGCGTCAGTAAGATAAGT
TAGGGTTATAACCAAGCCC->AGGGTTATAACCAAGCCCA
AGGGTTATAACCAAGCCCA->GGGTTATAACCAAGCCCAT
TTATACCACAATCCCTAGC->TATACCACAATCCCTAGCC
TATACCACAATCCCTAGCC->ATACCACAATCCCTAGCCT
TATTTTTTATCTGGACGCT->ATTTTTTATCTGGACGCTT
CCTACTAAGACACCTAACT->CTACTAAGACACCTAACTA
CTCTAGGGTTATAACCAAG->TCTAGGGTTATAACCAAGC
TCAGCTGTATTCAGGACCC->CAGCTGTATTCAGGACCCT
TGTGGGCGGTCTTGCTACC->GTGGGCGGTCTTGCTACCA
GCAGCATCCCAACGAGCTT->CAGCATCCCAACGAGCTTT
AGACCACGGAAGCCTATAG->GACCACGGAAGCCTATAGT
GACCACGGAAGCCTATAGT->ACCACGGAAGCCTATAGTA
AACGAGACGGTTCCGTGGG->ACGAGACGGTTCCGTGGGC
ACGAGACGGTTCCGTGGGC->CGAGACGGTTCCGTGGGCG
ACTCAGATGGGATAGCACC->CTCAGATGGGATAGCACCC
CTCAGATGGGATAGCACCC->TCAGATGGGATAGCACCCT
ACCTATTCGTTGGGAATGC->CCTATTCGTTGGGAATGCA
GACACCGGGAACTGTCAAC->ACACCGGGAACTGTCAACC
GAGGTCCCCGCAAAATACC->AGGTCCCCGCAAAATACCG
ATCAGCAGCTGGGATTTAG->TCAGCAGCTGGGATTTAGC
TCAGCAGCTGGGATTTAGC->CAGCAGCTGGGATTTAGCC
GACGATACCCCGGGCCAAG->ACGATACCCCGGGCCAAGA
ATCTACGCCATTTACCGTT->TCTACGCCATTTACCGTTC
CCGATGTATTCAGGACCCT->CGATGTATTCAGGACCCTC
TCTAGACCCCTAACCTAGG->CTAGACCCCTAACCTAGGT
CTAGACCCCTAACCTAGGT->TAGACCCCTAACCTAGGTG
CATCTAGACCCCTAACCTA->ATCTAGACCCCTAACCTAG
CACCGCTCTCTAGGGTTAT->ACCGCTCTCTAGGGTTATA
GTCAGTAAGATAAGTCAAA->TCAGTAAGATAAGTCAAAG
GTCGCACTGGAGCAGGTTA->TCGCACTGGAGCAGGTTAA
TCGCACTGGAGCAGGTTAA->CGCACTGGAGCAGGTTAAA
CCCCTAACCTAGGTGTTTT->CCCTAACCTAGGTGTTTTA
GCTACCAAGAACCAACACA->CTACCAAGAACCAACACAA
CTACCAAGAACCAACACAA->TACCAAGAACCAACACAAC
CCATGACTGCCCGGAAACA->CATGACTGCCCGGAAACAA
CATGACTGCCCGGAAACAA->ATGACTGCCCGGAAACAAA
TAACGAGACGGTTCCGTGG->AACGAGACGGTTCCGTGGG
CCAACACAACGACGCAACC->CAACACAACGACGCAACCT
ATTAAGCATAAGCAGTGCT->TTAAGCATAAGCAGTGCTA
TCGCATCGGGACCTCCTAT->CGCATCGGGACCTCCTATT
GTAGTCAAGGCTTTAACCA->TAGTCAAGGCTTTAACCAG
TAGTCAAGGCTTTAACCAG->AGTCAAGGCTTTAACCAGT
CTCTGAGGAAGGGATGACC->TCTGAGGAAGGGATGACCA
ACTGGAGCAGGTTAAAGTG->CTGGAGCAGGTTAAAGTGG
GGGGTCAGTTCGGCCTTTT->GGGTCAGTTCGGCCTTTTG
AAAAGCCGTTCAAAAAGTA->AAAGCCGTTCAAAAAGTAT
AAAGCCGTTCAAAAAGTAT->AAGCCGTTCAAAAAGTATG
AACACCCCTTCTGTCAGCC->ACACCCCTTCTGTCAGCCG
ATTACAATGTCTCGCTCTA->TTACAATGTCTCGCTCTAG
TTACAATGTCTCGCTCTAG->TACAATGTCTCGCTCTAGA
ATTCGTAAGCCGCCATGGC->TTCGTAAGCCGCCATGGCT
CTACGCCATTTACCGTTCC->TACGCCATTTACCGTTCCA
GGCACATAATTTTTATTTT->GCACATAATTTTTATTTTG
AAGGGGTCTGGACTCTATT->AGGGGTCTGGACTCTATTG
AGGGGTCTGGACTCTATTG->GGGGTCTGGACTCTATTGG
ACTCTTGGTTAGTTTTTCA->CTCTTGGTTAGTTTTTCAG
CTCTTGGTTAGTTTTTCAG->TCTTGGTTAGTTTTTCAGC
GAAGACTGACTCAAGGGGT->AAGACTGACTCAAGGGGTC
CGCTGTCCCACATCTAGAC->GCTGTCCCACATCTAGACC
GACGGTGTATCCGCCCTCA->ACGGTGTATCCGCCCTCAC
CGGGAATGCCGGTTTACCT->GGGAATGCCGGTTTACCTT
GGGAATGCCGGTTTACCTT->GGAATGCCGGTTTACCTTC
GGAAACAAAAGATGCGTGG->GAAACAAAAGATGCGTGGC
GAAACAAAAGATGCGTGGC->AAACAAAAGATGCGTGGCA
CTGTGGCCCTAGCTCACAC->TGTGGCCCTAGCTCACACC
TCTGAGGAAGGGATGACCA->CTGAGGAAGGGATGACCAC
TTATCTGGACGCTTAACAT->TATCTGGACGCTTAACATA
TATCTGGACGCTTAACATA->ATCTGGACGCTTAACATAC
AGACTGACTCAAGGGGTCT->GACTGACTCAAGGGGTCTG
AAGACAGTTGTTTCGAGTA->AGACAGTTGTTTCGAGTAA
TGGACTCTATTGGGGCTAA->GGACTCTATTGGGGCTAAC
CGGCTGGGATGTTGATTTT->GGCTGGGATGTTGATTTTA
CGTTCCATGTCGACCCACG->GTTCCATGTCGACCCACGA
TTATACCTATTCGTTGGGA->TATACCTATTCGTTGGGAA
TATACCTATTCGTTGGGAA->ATACCTATTCGTTGGGAAT
CGTCCTGTGGGCGGTCTTG->GTCCTGTGGGCGGTCTTGC
GTCCTGTGGGCGGTCTTGC->TCCTGTGGGCGGTCTTGCT
CATACAGGAGTAAAAGCCT->ATACAGGAGTAAAAGCCTG
ATACAGGAGTAAAAGCCTG->TACAGGAGTAAAAGCCTGG
GAGGGCGCAGTAGTGCCGG->AGGGCGCAGTAGTGCCGGG
GCCAACACCCCTTCTGTCA->CCAACACCCCTTCTGTCAG
CCAACACCCCTTCTGTCAG->CAACACCCCTTCTGTCAGC
AGATCTCCGGGTAAATCCC->GATCTCCGGGTAAATCCCA
TTAGATGCATCATTAAGCA->TAGATGCATCATTAAGCAT
TCAGCCTCCCCGTCTCCGC->CAGCCTCCCCGTCTCCGCT
ACCCTCCGAATTTCTGCGA->CCCTCCGAATTTCTGCGAT
ACCCCGGGCCAAGACTATG->CCCCGGGCCAAGACTATGG
CCCCGGGCCAAGACTATGG->CCCGGGCCAAGACTATGGT
GACCACGCTTTAGTACATC->ACCACGCTTTAGTACATCA
AAACGAGGGACTATTCGTA->AACGAGGGACTATTCGTAC
AACGAGGGACTATTCGTAC->ACGAGGGACTATTCGTACG
CGCCCCACGACACCGGGAA->GCCCCACGACACCGGGAAC
GCGCCCGATCTGTCTAGAA->CGCCCGATCTGTCTAGAAT
GGCTCCCCGGTAGGAAGCG->GCTCCCCGGTAGGAAGCGA
CTGGGATGTTGATTTTATT->TGGGATGTTGATTTTATTC
AATGTTAGTATAGTATTCA->ATGTTAGTATAGTATTCAA
CCGAACCGCCCCAAACTGT->CGAACCGCCCCAAACTGTG
CAATGGAATATGCCTCGAT->AATGGAATATGCCTCGATC
CTGTCGGGAGGAGAACCAT->TGTCGGGAGGAGAACCATG
TGTCGGGAGGAGAACCATG->GTCGGGAGGAGAACCATGA
GAGGATATTCGTAAGCCGC->AGGATATTCGTAAGCCGCC
AGGATATTCGTAAGCCGCC->GGATATTCGTAAGCCGCCA
CGCAAAATGGACTCGCTCC->GCAAAATGGACTCGCTCCC
GCAAAATGGACTCGCTCCC->CAAAATGGACTCGCTCCCT
TCACGATTCTTACCTATGG->CACGATTCTTACCTATGGT
GACTCTATTGGGGCTAACC->ACTCTATTGGGGCTAACCT
AACGTAAGATCTCCGGGTA->ACGTAAGATCTCCGGGTAA
GTTACTGATCAGTTTTGAA->TTACTGATCAGTTTTGAAA
CTGGAGCAGGTTAAAGTGG->TGGAGCAGGTTAAAGTGGA
CTCCGAATTTCAGGCCGGG->TCCGAATTTCAGGCCGGGA
TCCGAATTTCAGGCCGGGA->CCGAATTTCAGGCCGGGAC
GGAAGGGATGACCACGCTT->GAAGGGATGACCACGCTTT
GAAGGGATGACCACGCTTT->AAGGGATGACCACGCTTTA
CCCTCCGAACCGCCCCAAA->CCTCCGAACCGCCCCAAAC
TGTCAACCTAAATGGACGA->GTCAACCTAAATGGACGAT
CATCACTACTAACTTTACG->ATCACTACTAACTTTACGG
GAGAGGACGGTGTATCCGC->AGAGGACGGTGTATCCGCC
GCTGTCTTTTGGACCTAAT->CTGTCTTTTGGACCTAATT
CTGTCTTTTGGACCTAATT->TGTCTTTTGGACCTAATTG
TCTTTTGGACCTAATTGTG->CTTTTGGACCTAATTGTGG
ACGTAAGATCTCCGGGTAA->CGTAAGATCTCCGGGTAAA
GTCTCAGTATGAGGTCCCC->TCTCAGTATGAGGTCCCCG
TTGCTACCAAGAACCAACA->TGCTACCAAGAACCAACAC
TGCTACCAAGAACCAACAC->GCTACCAAGAACCAACACA
ATCTAGACCCCTAACCTAG->TCTAGACCCCTAACCTAGG
GAGAACCATGACTGCCCGG->AGAACCATGACTGCCCGGA
GCCTATAGTATCATTCGTC->CCTATAGTATCATTCGTCG
CCCTCCTACTAAGACACCT->CCTCCTACTAAGACACCTA
TCTTACCTATGGTTTTACG->CTTACCTATGGTTTTACGT
CTTACCTATGGTTTTACGT->TTACCTATGGTTTTACGTC
GTAAATCCCAGGAGAGGCT->TAAATCCCAGGAGAGGCTC
ATTATAGTAGAGGCCCGCG->TTATAGTAGAGGCCCGCGG
TTATAGTAGAGGCCCGCGG->TATAGTAGAGGCCCGCGGT
AGTTCCCCAACGAGAGGAC->GTTCCCCAACGAGAGGACG
GTTCCCCAACGAGAGGACG->TTCCCCAACGAGAGGACGG
ACGTAGCACGTGGGCTTTA->CGTAGCACGTGGGCTTTAT
CCGAGAGGCCCTGTAAAAT->CGAGAGGCCCTGTAAAATC
GCCTCCCCGTCTCCGCTCC->CCTCCCCGTCTCCGCTCCA
AAGACACCTAACTATCAAA->AGACACCTAACTATCAAAA
CGGCTTACTAACTGTCGGG->GGCTTACTAACTGTCGGGA
GGCTTACTAACTGTCGGGA->GCTTACTAACTGTCGGGAG
CCTTCCATAACGAACGCGT->CTTCCATAACGAACGCGTA
GAGGCCCGCGGTTGAGTAA->AGGCCCGCGGTTGAGTAAC
AAGCCGTTCAAAAAGTATG->AGCCGTTCAAAAAGTATGA
TGACTGCCCGGAAACAAAA->GACTGCCCGGAAACAAAAG
TTAGTACATCAATGGAATA->TAGTACATCAATGGAATAT
ATACAGCGCCGTATTCAGG->TACAGCGCCGTATTCAGGA
CCTCGATCAAGACAGTTGT->CTCGATCAAGACAGTTGTT
CACAATCCCTAGCCTAAAT->ACAATCCCTAGCCTAAATG
TGCGATCCGAACGCGACGA->GCGATCCGAACGCGACGAG
AGGACATGTCGTCGCGCCG->GGACATGTCGTCGCGCCGA
TGGGATTTAGCCTTGGCTC->GGGATTTAGCCTTGGCTCA
TTGGTACTATATGCAGGGG->TGGTACTATATGCAGGGGC
TGGTACTATATGCAGGGGC->GGTACTATATGCAGGGGCA
CCACGACGGATCAAGGTCA->CACGACGGATCAAGGTCAC
GCCCCACGACACCGGGAAC->CCCCACGACACCGGGAACT
ACCACAATCCCTAGCCTAA->CCACAATCCCTAGCCTAAA
CCACAATCCCTAGCCTAAA->CACAATCCCTAGCCTAAAT
GATCTGTCTAGAATAAAGC->ATCTGTCTAGAATAAAGCC
CGCTTAGATGCATCATTAA->GCTTAGATGCATCATTAAG
TTTCAGCCTCCCCGTCTCC->TTCAGCCTCCCCGTCTCCG
GATGTCACGATTCTTACCT->ATGTCACGATTCTTACCTA
CATCGGGACCTCCTATTAC->ATCGGGACCTCCTATTACA
ATCGGGACCTCCTATTACA->TCGGGACCTCCTATTACAA
TACCTATGGTTTTACGTCA->ACCTATGGTTTTACGTCAG
GTCTCCGCTCCAGCGCCCG->TCTCCGCTCCAGCGCCCGA
GCACATCAGCAGCTGGGAT->CACATCAGCAGCTGGGATT
CACATCAGCAGCTGGGATT->ACATCAGCAGCTGGGATTT
ATGACTCTTGGTTAGTTTT->TGACTCTTGGTTAGTTTTT
TCAGCCGAGAGGCCCTGTA->CAGCCGAGAGGCCCTGTAA
CAGCCGAGAGGCCCTGTAA->AGCCGAGAGGCCCTGTAAA
CACCTTATACCACAATCCC->ACCTTATACCACAATCCCT
ACCTTATACCACAATCCCT->CCTTATACCACAATCCCTA
ATACATACAGGAGTAAAAG->TACATACAGGAGTAAAAGC
ATACCCCGGGCCAAGACTA->TACCCCGGGCCAAGACTAT
TACCCCGGGCCAAGACTAT->ACCCCGGGCCAAGACTATG
GATTCTTACCTATGGTTTT->ATTCTTACCTATGGTTTTA
ATTCTTACCTATGGTTTTA->TTCTTACCTATGGTTTTAC
CGAGCTTTTAATGTTAGTA->GAGCTTTTAATGTTAGTAT
CCGTCCTGTGGGCGGTCTT->CGTCCTGTGGGCGGTCTTG
AGCCTGGGTACCTTCCCAT->GCCTGGGTACCTTCCCATA
GCCTGGGTACCTTCCCATA->CCTGGGTACCTTCCCATAC
CAACGACGCAACCTGTAAA->AACGACGCAACCTGTAAAC
TTGGACCTAATTGTGGGAG->TGGACCTAATTGTGGGAGG
CCTGGGTACCTTCCCATAC->CTGGGTACCTTCCCATACT
CTGGGTACCTTCCCATACT->TGGGTACCTTCCCATACTC
CGAACCGCCCCAAACTGTG->GAACCGCCCCAAACTGTGA
TAGACCGTCCTGTGGGCGG->AGACCGTCCTGTGGGCGGT
CAGCTCTGAGGAAGGGATG->AGCTCTGAGGAAGGGATGA
AAAAAGTATGATAGACGAT->AAAAGTATGATAGACGATA
AAAAGTATGATAGACGATA->AAAGTATGATAGACGATAC
TTCCGATACAGCGCCGTAT->TCCGATACAGCGCCGTATT
TCCGATACAGCGCCGTATT->CCGATACAGCGCCGTATTC
ATTGGTACTATATGCAGGG->TTGGTACTATATGCAGGGG
TAACCCACTCAGATGGGAT->AACCCACTCAGATGGGATA
ACATCAATGGAATATGCCT->CATCAATGGAATATGCCTC
ATCCCAACGAGCTTTTAAT->TCCCAACGAGCTTTTAATG
ATGACTGCCCGGAAACAAA->TGACTGCCCGGAAACAAAA
AGGGGCACATAATTTTTAT->GGGGCACATAATTTTTATT
TGCCAGGAACGATGATTTT->GCCAGGAACGATGATTTTG
GCCAGGAACGATGATTTTG->CCAGGAACGATGATTTTGG
CGAGCTCCTGCACATCAGC->GAGCTCCTGCACATCAGCA
CTTAGATGCATCATTAAGC->TTAGATGCATCATTAAGCA
ACTTGAAAGCCTGGGTACC->CTTGAAAGCCTGGGTACCT
ACCTGTAAACGTCCTTGAC->CCTGTAAACGTCCTTGACG
CCTGTAAACGTCCTTGACG->CTGTAAACGTCCTTGACGT
TAACCAAGCCCATCGCGCC->AACCAAGCCCATCGCGCCT
ACCGATACGTGCTGAAGAC->CCGATACGTGCTGAAGACT
TTACTGATCAGTTTTGAAA->TACTGATCAGTTTTGAAAC
TTCTTGGGAAGATGTCACG->TCTTGGGAAGATGTCACGA
AGACGGTTCCGTGGGCGAG->GACGGTTCCGTGGGCGAGC
GACGGTTCCGTGGGCGAGC->ACGGTTCCGTGGGCGAGCT
GTTATACCTATTCGTTGGG->TTATACCTATTCGTTGGGA
AAGATCTCCGGGTAAATCC->AGATCTCCGGGTAAATCCC
TCACGGTGCGATGCGCTTA->CACGGTGCGATGCGCTTAG
CTAACTATCAAAAGTTGCT->TAACTATCAAAAGTTGCTC
GAAACGAGGGACTATTCGT->AAACGAGGGACTATTCGTA
GTTCCGTGGGCGAGCTCCT->TTCCGTGGGCGAGCTCCTG
ACACCTTATACCACAATCC->CACCTTATACCACAATCCC
CTCAGTTCCCCAACGAGAG->TCAGTTCCCCAACGAGAGG
TACTCTGATGTTCGCAAAA->ACTCTGATGTTCGCAAAAT
TGCACTTCACGGTGCGATG->GCACTTCACGGTGCGATGC
CCCCTTATAGCTAATGCGA->CCCTTATAGCTAATGCGAG
CCCTTATAGCTAATGCGAG->CCTTATAGCTAATGCGAGT
TCTACGCCATTTACCGTTC->CTACGCCATTTACCGTTCC
GGTGCTGGAGGATATTCGT->GTGCTGGAGGATATTCGTA
GATGACCACGCTTTAGTAC->ATGACCACGCTTTAGTACA
AACGCGTATTCAGGACCCT->ACGCGTATTCAGGACCCTC
ACGCGTATTCAGGACCCTC->CGCGTATTCAGGACCCTCC
TTGTGGGAGGCGATCCTGT->TGTGGGAGGCGATCCTGTG
TGTGGGAGGCGATCCTGTG->GTGGGAGGCGATCCTGTGG
TACCACAATCCCTAGCCTA->ACCACAATCCCTAGCCTAA
CTGTAAACGTCCTTGACGT->TGTAAACGTCCTTGACGTC
CTCCTACTTGAAAGCCTGG->TCCTACTTGAAAGCCTGGG
CTGCACATCAGCAGCTGGG->TGCACATCAGCAGCTGGGA
TGCACATCAGCAGCTGGGA->GCACATCAGCAGCTGGGAT
TCAGTTTTGAAACGAGGGA->CAGTTTTGAAACGAGGGAC
CAGTTTTGAAACGAGGGAC->AGTTTTGAAACGAGGGACT
CAGTTCCCCAACGAGAGGA->AGTTCCCCAACGAGAGGAC
AGATGCGTGGCAGCATCCC->GATGCGTGGCAGCATCCCA
GATGCGTGGCAGCATCCCA->ATGCGTGGCAGCATCCCAA
CCCTCCGAATTTCAGGCCG->CCTCCGAATTTCAGGCCGG
CCTCCGAATTTCAGGCCGG->CTCCGAATTTCAGGCCGGG
ACAGTCGCAGCTCTGAGGA->CAGTCGCAGCTCTGAGGAA
TGAAACGAGGGACTATTCG->GAAACGAGGGACTATTCGT
GGGAATGCAAACGTCGCTG->GGAATGCAAACGTCGCTGT
GATTGCCAGGAACGATGAT->ATTGCCAGGAACGATGATT
ATTGCCAGGAACGATGATT->TTGCCAGGAACGATGATTT
GCCTCTTATTTTTAGAATT->CCTCTTATTTTTAGAATTG
ATTTCTGCGATCCGAACGC->TTTCTGCGATCCGAACGCG
AGGCTCGCGCCTCTTATTT->GGCTCGCGCCTCTTATTTT
CCAACGAGCTTTTAATGTT->CAACGAGCTTTTAATGTTA
GGAAGCGAATTATAGTAGA->GAAGCGAATTATAGTAGAG
AAAGCCTGGGTACCTTCCC->AAGCCTGGGTACCTTCCCA
ACCCACGACGGATCAAGGT->CCCACGACGGATCAAGGTC
CCCACGACGGATCAAGGTC->CCACGACGGATCAAGGTCA
TTCAGGACCCTCCGAACCG->TCAGGACCCTCCGAACCGC
TCAGGACCCTCCGAACCGC->CAGGACCCTCCGAACCGCC
AATGCCGGTTTACCTTCAA->ATGCCGGTTTACCTTCAAG
GCATCCCAACGAGCTTTTA->CATCCCAACGAGCTTTTAA
CATCCCAACGAGCTTTTAA->ATCCCAACGAGCTTTTAAT
TTTTTATTTTGATCATCTA->TTTTATTTTGATCATCTAC
AAGTATGATAGACGATACC->AGTATGATAGACGATACCC
AGTATGATAGACGATACCC->GTATGATAGACGATACCCC
AAGCAGTGCTAACGCCCCA->AGCAGTGCTAACGCCCCAC
AGCAGTGCTAACGCCCCAC->GCAGTGCTAACGCCCCACG
GTGCCGGGTACCGGTAGTC->TGCCGGGTACCGGTAGTCA
GCCCTAGCTCACACCAACT->CCCTAGCTCACACCAACTA
CAGTTGTTTCGAGTAATTC->AGTTGTTTCGAGTAATTCA
TAAAAGCCTGGGTACCTTC->AAAAGCCTGGGTACCTTCC
AAAAGCCTGGGTACCTTCC->AAAGCCTGGGTACCTTCCA
ATACTCCTACTTGAAAGCC->TACTCCTACTTGAAAGCCT
TATGGTTCGCTGTTACTGA->ATGGTTCGCTGTTACTGAT
ATGGTTCGCTGTTACTGAT->TGGTTCGCTGTTACTGATC
GCCACTCCAATTTATTCAA->CCACTCCAATTTATTCAAT
CCACTCCAATTTATTCAAT->CACTCCAATTTATTCAATA
ATATTTTTTATCTGGACGC->TATTTTTTATCTGGACGCT
TAGTACATCAATGGAATAT->AGTACATCAATGGAATATG
GCAAACGTCGCTGTCTTTT->CAAACGTCGCTGTCTTTTG
AGATCATTCCGCTGCACAG->GATCATTCCGCTGCACAGG
ACCACGGAAGCCTATAGTA->CCACGGAAGCCTATAGTAT
TTAGAATTGAGATACTCCT->TAGAATTGAGATACTCCTA
GGCTTTAACCAGTAGACAG->GCTTTAACCAGTAGACAGT
AGGACCCTCCGAACCGCCC->GGACCCTCCGAACCGCCCC
GGACCCTCCGAACCGCCCC->GACCCTCCGAACCGCCCCA
GAGTAACGGCCTGTCGAAG->AGTAACGGCCTGTCGAAGT
AGTAACGGCCTGTCGAAGT->GTAACGGCCTGTCGAAGTA
AAGGCTCCCCGGTAGGAAG->AGGCTCCCCGGTAGGAAGC
AGGCTCCCCGGTAGGAAGC->GGCTCCCCGGTAGGAAGCG
ATCTGGACGCTTAACATAC->TCTGGACGCTTAACATACA
GGCAGCATCCCAACGAGCT->GCAGCATCCCAACGAGCTT
TGTTGATTTTATTCTTGAC->GTTGATTTTATTCTTGACA
GTTGATTTTATTCTTGACA->TTGATTTTATTCTTGACAC
GTTTTAGCAATAGGATACA->TTTTAGCAATAGGATACAT
TTTTAGCAATAGGATACAT->TTTAGCAATAGGATACATA
CCCCAAACTGTGACCTGCA->CCCAAACTGTGACCTGCAC
GGCCAAGACTATGGTTCGC->GCCAAGACTATGGTTCGCT
GCCAAGACTATGGTTCGCT->CCAAGACTATGGTTCGCTG
AGTGCTAACGCCCCACGAC->GTGCTAACGCCCCACGACA
GTGCTAACGCCCCACGACA->TGCTAACGCCCCACGACAC
TAAGATCTCCGGGTAAATC->AAGATCTCCGGGTAAATCC
CATCCCGATGTATTCAGGA->ATCCCGATGTATTCAGGAC
ATGCCGGTTTACCTTCAAG->TGCCGGTTTACCTTCAAGA
CTTTGACGGTGCTGGAGGA->TTTGACGGTGCTGGAGGAT
TTTGACGGTGCTGGAGGAT->TTGACGGTGCTGGAGGATA
TATTACAATGTCTCGCTCT->ATTACAATGTCTCGCTCTA
CAGGGGCACATAATTTTTA->AGGGGCACATAATTTTTAT
AGGTTAAAGTGGAGTCAGA->GGTTAAAGTGGAGTCAGAG
GATACAGCGCCGTATTCAG->ATACAGCGCCGTATTCAGG
ACTGTCAACCTAAATGGAC->CTGTCAACCTAAATGGACG
CTGTCAACCTAAATGGACG->TGTCAACCTAAATGGACGA
ATTCCCGTCAAGTACTCTG->TTCCCGTCAAGTACTCTGA
TTCCCGTCAAGTACTCTGA->TCCCGTCAAGTACTCTGAT
TACCAAGAACCAACACAAC->ACCAAGAACCAACACAACG
CGGCGCAGATCATTCCGCT->GGCGCAGATCATTCCGCTG
CGCCCCAAACTGTGACCTG->GCCCCAAACTGTGACCTGC
CCCTCCGAATTTCTGCGAT->CCTCCGAATTTCTGCGATC
GATTTTGGATGAAGACTGA->ATTTTGGATGAAGACTGAC
ACACAACGACGCAACCTGT->CACAACGACGCAACCTGTA
TTCGCTGTTACTGATCAGT->TCGCTGTTACTGATCAGTT
TCCACGCTGTCCCACATCT->CCACGCTGTCCCACATCTA
CCCTCCGAAGTTCATCGGA->CCTCCGAAGTTCATCGGAC
CCTCCGAAGTTCATCGGAC->CTCCGAAGTTCATCGGACG
ATACCTATTCGTTGGGAAT->TACCTATTCGTTGGGAATG
TACCTATTCGTTGGGAATG->ACCTATTCGTTGGGAATGC
ACCTTCCTCCATCCCGATG->CCTTCCTCCATCCCGATGT
TTGGGAATGCAAACGTCGC->TGGGAATGCAAACGTCGCT
GGTACTATATGCAGGGGCA->GTACTATATGCAGGGGCAC
CGAGAGGACGGTGTATCCG->GAGAGGACGGTGTATCCGC
TGTATCATCCTGATAGTCA->GTATCATCCTGATAGTCAA
AACCAACACAACGACGCAA->ACCAACACAACGACGCAAC
GTCGAAGGGGTCAGTTCGG->TCGAAGGGGTCAGTTCGGC
GAGGGACTATTCGTACGCA->AGGGACTATTCGTACGCAT
TCACCGGGGCGAATATTTT->CACCGGGGCGAATATTTTT
CACCGGGGCGAATATTTTT->ACCGGGGCGAATATTTTTT
TGCAGGGGCACATAATTTT->GCAGGGGCACATAATTTTT
GCAGGGGCACATAATTTTT->CAGGGGCACATAATTTTTA
ACCTAAATGGACGATGTCG->CCTAAATGGACGATGTCGC
GTCGGGAGGAGAACCATGA->TCGGGAGGAGAACCATGAC
TCACGCTACTGAGAAAAGC->CACGCTACTGAGAAAAGCC
AGCGAATTATAGTAGAGGC->GCGAATTATAGTAGAGGCC
GCGAATTATAGTAGAGGCC->CGAATTATAGTAGAGGCCC
TCAAGGTCACGGCGCAGAT->CAAGGTCACGGCGCAGATC
CAAGGTCACGGCGCAGATC->AAGGTCACGGCGCAGATCA
CCCTAACCTAGGTGTTTTA->CCTAACCTAGGTGTTTTAG
GCGCAGTAGTGCCGGGTAC->CGCAGTAGTGCCGGGTACC
AGGGCGCAGTAGTGCCGGG->GGGCGCAGTAGTGCCGGGT
CTCCGAAGTTCATCGGACG->TCCGAAGTTCATCGGACGT
TCCGAAGTTCATCGGACGT->CCGAAGTTCATCGGACGTA
AATACCGGGAATGCCGGTT->ATACCGGGAATGCCGGTTT
GCCGCCATGGCTGCGTCAG->CCGCCATGGCTGCGTCAGT
TCTTATTTTTAGAATTGAG->CTTATTTTTAGAATTGAGA
CTTATTTTTAGAATTGAGA->TTATTTTTAGAATTGAGAT
CGCTACTGAGAAAAGCCGT->GCTACTGAGAAAAGCCGTT
CCCGGGCCAAGACTATGGT->CCGGGCCAAGACTATGGTT
GCTGGGATGTTGATTTTAT->CTGGGATGTTGATTTTATT
ACGATGATTTTGGATGAAG->CGATGATTTTGGATGAAGA
TTCAGCCTCCCCGTCTCCG->TCAGCCTCCCCGTCTCCGC
CAGGACCCTCCGAACCGCC->AGGACCCTCCGAACCGCCC
GTGTCTCAGGGATTTCTTG->TGTCTCAGGGATTTCTTGG
TGTCTCAGGGATTTCTTGG->GTCTCAGGGATTTCTTGGG
CGGCCTTTTGAACCATCTG->GGCCTTTTGAACCATCTGC
AGGACCCTCCGAATTTCTG->GGACCCTCCGAATTTCTGC
ATTTAGCCTTGGCTCAGTT->TTTAGCCTTGGCTCAGTTC
CCCGCGGTTGAGTAACGGC->CCGCGGTTGAGTAACGGCC
CCGCGGTTGAGTAACGGCC->CGCGGTTGAGTAACGGCCT
GTAGGAAGCGAATTATAGT->TAGGAAGCGAATTATAGTA
AAGATGCGTGGCAGCATCC->AGATGCGTGGCAGCATCCC
GCATTACTTGTATCATCCT->CATTACTTGTATCATCCTG
CGAATTATAGTAGAGGCCC->GAATTATAGTAGAGGCCCG
TCACGGCGCAGATCATTCC->CACGGCGCAGATCATTCCG
CAGGCCGGGACGCGTTATA->AGGCCGGGACGCGTTATAC
AGGCCGGGACGCGTTATAC->GGCCGGGACGCGTTATACC
GAATTATAGTAGAGGCCCG->AATTATAGTAGAGGCCCGC
GATGACTCTTGGTTAGTTT->ATGACTCTTGGTTAGTTTT
ACCAACACAACGACGCAAC->CCAACACAACGACGCAACC
TACCTTCAAGAGTAGTCAC->ACCTTCAAGAGTAGTCACC
ACCTTCAAGAGTAGTCACC->CCTTCAAGAGTAGTCACCG
AAAGTATGATAGACGATAC->AAGTATGATAGACGATACC
AGTTTTGAAACGAGGGACT->GTTTTGAAACGAGGGACTA
CCTGTGGGCGGTCTTGCTA->CTGTGGGCGGTCTTGCTAC
CTGTGGGCGGTCTTGCTAC->TGTGGGCGGTCTTGCTACC
TTTTGATCATCTACGCCAT->TTTGATCATCTACGCCATT
TACCGATACGTGCTGAAGA->ACCGATACGTGCTGAAGAC
AACTGTGACCTGCACTTCA->ACTGTGACCTGCACTTCAC
ACTGTGACCTGCACTTCAC->CTGTGACCTGCACTTCACG
GGATTTCTTGGGAAGATGT->GATTTCTTGGGAAGATGTC
CTAAGACACCTAACTATCA->TAAGACACCTAACTATCAA
TAAGACACCTAACTATCAA->AAGACACCTAACTATCAAA
AAGTAACCCACTCAGATGG->AGTAACCCACTCAGATGGG
TTGTTTCGAGTAATTCACG->TGTTTCGAGTAATTCACGT
ACATGTCGTCGCGCCGAGG->CATGTCGTCGCGCCGAGGG
TTTAATGTTAGTATAGTAT->TTAATGTTAGTATAGTATT
GGATGTTGATTTTATTCTT->GATGTTGATTTTATTCTTG
AGCGCCGTATTCAGGACCC->GCGCCGTATTCAGGACCCT
GCGCCGTATTCAGGACCCT->CGCCGTATTCAGGACCCTC
CACCTAACTATCAAAAGTT->ACCTAACTATCAAAAGTTG
CTCCAATTTATTCAATAAC->TCCAATTTATTCAATAACG
CCCCAACGAGAGGACGGTG->CCCAACGAGAGGACGGTGT
CCCAACGAGAGGACGGTGT->CCAACGAGAGGACGGTGTA
GGTAAATCCCAGGAGAGGC->GTAAATCCCAGGAGAGGCT
GATCAAGACAGTTGTTTCG->ATCAAGACAGTTGTTTCGA
ACGAGGGACTATTCGTACG->CGAGGGACTATTCGTACGC
TGAGTAACGGCCTGTCGAA->GAGTAACGGCCTGTCGAAG
ATGTCGACCCACGACGGAT->TGTCGACCCACGACGGATC
TATAGTATTCAAGCCACTC->ATAGTATTCAAGCCACTCC
ATAGTATTCAAGCCACTCC->TAGTATTCAAGCCACTCCA
TTGCCAGGAACGATGATTT->TGCCAGGAACGATGATTTT
TATAGTAGAGGCCCGCGGT->ATAGTAGAGGCCCGCGGTT
CGACACCGGGAACTGTCAA->GACACCGGGAACTGTCAAC
ACGCGTTATACCTATTCGT->CGCGTTATACCTATTCGTT
ACGTGATTGGTACTATATG->CGTGATTGGTACTATATGC
CGGTGCGATGCGCTTAGAT->GGTGCGATGCGCTTAGATG
GGTGCGATGCGCTTAGATG->GTGCGATGCGCTTAGATGC
AAGACTGACTCAAGGGGTC->AGACTGACTCAAGGGGTCT
TGCGCTCTACTTAGGACAT->GCGCTCTACTTAGGACATG
CTAAATGTCTCAGTATGAG->TAAATGTCTCAGTATGAGG
TAAATGTCTCAGTATGAGG->AAATGTCTCAGTATGAGGT
TGGGAATGCAAACGTCGCT->GGGAATGCAAACGTCGCTG
TTTTAATGTTAGTATAGTA->TTTAATGTTAGTATAGTAT
TGCGTGGCAGCATCCCAAC->GCGTGGCAGCATCCCAACG
GCGTGGCAGCATCCCAACG->CGTGGCAGCATCCCAACGA
ATTCAAGCCACTCCAATTT->TTCAAGCCACTCCAATTTA
TTCAAGCCACTCCAATTTA->TCAAGCCACTCCAATTTAT
GGGTACCGGTAGTCAAGGC->GGTACCGGTAGTCAAGGCT
GGTACCGGTAGTCAAGGCT->GTACCGGTAGTCAAGGCTT
TTTAGCAATAGGATACATA->TTAGCAATAGGATACATAC
CGAACGCGTATTCAGGACC->GAACGCGTATTCAGGACCC
AACCTCCACGCTGTCCCAC->ACCTCCACGCTGTCCCACA
CATCAATGGAATATGCCTC->ATCAATGGAATATGCCTCG
CTCGATCAAGACAGTTGTT->TCGATCAAGACAGTTGTTT
TCGATCAAGACAGTTGTTT->CGATCAAGACAGTTGTTTC
TGATAGACGATACCCCGGG->GATAGACGATACCCCGGGC
CAAAATGGACTCGCTCCCT->AAAATGGACTCGCTCCCTC
AAAATGGACTCGCTCCCTC->AAATGGACTCGCTCCCTCC
GGATGACCACGCTTTAGTA->GATGACCACGCTTTAGTAC
GGGTACCTTCCCATACTCA->GGTACCTTCCCATACTCAG
GGTACCTTCCCATACTCAG->GTACCTTCCCATACTCAGC
AAGGGATGACCACGCTTTA->AGGGATGACCACGCTTTAG
TGTCGACCCACGACGGATC->GTCGACCCACGACGGATCA
GTCGACCCACGACGGATCA->TCGACCCACGACGGATCAA
TGGAGCAGGTTAAAGTGGA->GGAGCAGGTTAAAGTGGAG
CCGCCCTCACGCTACTGAG->CGCCCTCACGCTACTGAGA
GAACGCGTATTCAGGACCC->AACGCGTATTCAGGACCCT
AATAGGATACATACAGGAG->ATAGGATACATACAGGAGT
TATAACCAAGCCCATCGCG->ATAACCAAGCCCATCGCGC
CCTTCAAGAGTAGTCACCG->CTTCAAGAGTAGTCACCGC
TTGAACCATCTGCAAAGAC->TGAACCATCTGCAAAGACC
TGTTTTAGCAATAGGATAC->GTTTTAGCAATAGGATACA
TAGACCCCTAACCTAGGTG->AGACCCCTAACCTAGGTGT
GGACTCTATTGGGGCTAAC->GACTCTATTGGGGCTAACC
GGGTAAATCCCAGGAGAGG->GGTAAATCCCAGGAGAGGC
AAGCCTGGGTACCTTCCCA->AGCCTGGGTACCTTCCCAT
CCTAACCTAGGTGTTTTAG->CTAACCTAGGTGTTTTAGC
GCGCTCTACTTAGGACATG->CGCTCTACTTAGGACATGT
TATGGTTTTACGTCAGCGA->ATGGTTTTACGTCAGCGAC
TTCTTACCTATGGTTTTAC->TCTTACCTATGGTTTTACG
CGATCAAGACAGTTGTTTC->GATCAAGACAGTTGTTTCG
TCGACCCACGACGGATCAA->CGACCCACGACGGATCAAG
AATTTCAGGCCGGGACGCG->ATTTCAGGCCGGGACGCGT
CGCGTCGAAGGGGTCAGTT->GCGTCGAAGGGGTCAGTTC
GGCTGGGATGTTGATTTTA->GCTGGGATGTTGATTTTAT
CTACTAAGACACCTAACTA->TACTAAGACACCTAACTAT
TACTAAGACACCTAACTAT->ACTAAGACACCTAACTATC
TTTCGAGTAATTCACGTCA->TTCGAGTAATTCACGTCAC
GTTCGGCCTTTTGAACCAT->TTCGGCCTTTTGAACCATC
CTATGGTTTTACGTCAGCG->TATGGTTTTACGTCAGCGA
CAACGAGCTTTTAATGTTA->AACGAGCTTTTAATGTTAG
ATATGCAGGGGCACATAAT->TATGCAGGGGCACATAATT
TATGCAGGGGCACATAATT->ATGCAGGGGCACATAATTT
CAGCAGAATTCCCGTCAAG->AGCAGAATTCCCGTCAAGT
AGTTCGGCCTTTTGAACCA->GTTCGGCCTTTTGAACCAT
TTGGGAAGATGTCACGATT->TGGGAAGATGTCACGATTC
GCGAGCTCCTGCACATCAG->CGAGCTCCTGCACATCAGC
AAGCCTGGGTACCTTCCGA->AGCCTGGGTACCTTCCGAT
TCAGGACCCTCCGAAGTTC->CAGGACCCTCCGAAGTTCA
CGTGGCAGCATCCCAACGA->GTGGCAGCATCCCAACGAG
CCTCTTATTTTTAGAATTG->CTCTTATTTTTAGAATTGA
CTGCACAGGCCCGATTGCC->TGCACAGGCCCGATTGCCA
TACCTTCCGATACAGCGCC->ACCTTCCGATACAGCGCCG
TGAAGACTTTACTAGCTGA->GAAGACTTTACTAGCTGAT
GTATCCGCCCTCACGCTAC->TATCCGCCCTCACGCTACT
CATGTCGTCGCGCCGAGGG->ATGTCGTCGCGCCGAGGGC
CTAACCTGGCGGCTGGGAT->TAACCTGGCGGCTGGGATG
GATACGTGCTGAAGACTTT->ATACGTGCTGAAGACTTTA
ATACGTGCTGAAGACTTTA->TACGTGCTGAAGACTTTAC
ACTATATGCAGGGGCACAT->CTATATGCAGGGGCACATA
TAGTCACCGCTCTCTAGGG->AGTCACCGCTCTCTAGGGT
AGTCACCGCTCTCTAGGGT->GTCACCGCTCTCTAGGGTT
GCCCCAAACTGTGACCTGC->CCCCAAACTGTGACCTGCA
GTACCGGTAGTCAAGGCTT->TACCGGTAGTCAAGGCTTT
CCACGACACCGGGAACTGT->CACGACACCGGGAACTGTC
CCACGCTGTCCCACATCTA->CACGCTGTCCCACATCTAG
CTCTAGACCGTCCTGTGGG->TCTAGACCGTCCTGTGGGC
AGTACTCTGATGTTCGCAA->GTACTCTGATGTTCGCAAA
GTACTCTGATGTTCGCAAA->TACTCTGATGTTCGCAAAA
AGGCGATCCTGTGGCCCTA->GGCGATCCTGTGGCCCTAG
GCTCTAGACCGTCCTGTGG->CTCTAGACCGTCCTGTGGG
CCTTTGACGGTGCTGGAGG->CTTTGACGGTGCTGGAGGA
TTACTAGCTGATGTACTAT->TACTAGCTGATGTACTATA
TACTAGCTGATGTACTATA->ACTAGCTGATGTACTATAC
TTATTTTTAGAATTGAGAT->TATTTTTAGAATTGAGATA
AACCAGTAGACAGTCGCAG->ACCAGTAGACAGTCGCAGC
CGTCAAGTACTCTGATGTT->GTCAAGTACTCTGATGTTC
GTCAAGTACTCTGATGTTC->TCAAGTACTCTGATGTTCG
GATTTCTTGGGAAGATGTC->ATTTCTTGGGAAGATGTCA
AACCATGACTGCCCGGAAA->ACCATGACTGCCCGGAAAC
ACCATGACTGCCCGGAAAC->CCATGACTGCCCGGAAACA
ACTATGGTTCGCTGTTACT->CTATGGTTCGCTGTTACTG
CTATGGTTCGCTGTTACTG->TATGGTTCGCTGTTACTGA
ACGCTTTAGTACATCAATG->CGCTTTAGTACATCAATGG
GACGCTTAACATACATCGG->ACGCTTAACATACATCGGA
CAAAAAGTATGATAGACGA->AAAAAGTATGATAGACGAT
CAACACCCCTTCTGTCAGC->AACACCCCTTCTGTCAGCC
AAGTGGAGTCAGAGGTACC->AGTGGAGTCAGAGGTACCG
GAGCTTTTAATGTTAGTAT->AGCTTTTAATGTTAGTATA
TCGCGCCTTTGACGGTGCT->CGCGCCTTTGACGGTGCTG
AGATACTCCTACTTGAAAG->GATACTCCTACTTGAAAGC
TCAAAAAGTATGATAGACG->CAAAAAGTATGATAGACGA
CCCGATGTATTCAGGACCC->CCGATGTATTCAGGACCCT
AGGACCCTCCGAATTTCAG->GGACCCTCCGAATTTCAGG
CCGTTCCATGTCGACCCAC->CGTTCCATGTCGACCCACG
ATAACCAAGCCCATCGCGC->TAACCAAGCCCATCGCGCC
TGATAGTCAACCTCCACGC->GATAGTCAACCTCCACGCT
TCGGGAGGAGAACCATGAC->CGGGAGGAGAACCATGACT
TTTAGAATTGAGATACTCC->TTAGAATTGAGATACTCCT
CCTTATACCACAATCCCTA->CTTATACCACAATCCCTAG
CTTATACCACAATCCCTAG->TTATACCACAATCCCTAGC
GCCGTATTCAGGACCCTCC->CCGTATTCAGGACCCTCCG
CCGTATTCAGGACCCTCCG->CGTATTCAGGACCCTCCGA
ACCCTCCGAAGTTCATCGG->CCCTCCGAAGTTCATCGGA
CCTCCCCGTCTCCGCTCCA->CTCCCCGTCTCCGCTCCAG
CATCATTAAGCATAAGCAG->ATCATTAAGCATAAGCAGT
ACCGGGGCGAATATTTTTT->CCGGGGCGAATATTTTTTA
CGAGGGACTATTCGTACGC->GAGGGACTATTCGTACGCA
GGCCGGGACGCGTTATACC->GCCGGGACGCGTTATACCT
AAGAACCAACACAACGACG->AGAACCAACACAACGACGC
ATACCACAATCCCTAGCCT->TACCACAATCCCTAGCCTA
TGCAAACGTCGCTGTCTTT->GCAAACGTCGCTGTCTTTT
TCTTGGTTAGTTTTTCAGC->CTTGGTTAGTTTTTCAGCC
CTTGGTTAGTTTTTCAGCC->TTGGTTAGTTTTTCAGCCT
GTGCGATGCGCTTAGATGC->TGCGATGCGCTTAGATGCA
TAAGATAAGTCAAAGCCTG->AAGATAAGTCAAAGCCTGG
CGCGTATTCAGGACCCTCC->GCGTATTCAGGACCCTCCG
GAACGCGACGAGCCAACAC->AACGCGACGAGCCAACACC
CTTCCGATACAGCGCCGTA->TTCCGATACAGCGCCGTAT
GGATGAAGACTGACTCAAG->GATGAAGACTGACTCAAGG
TACCGGTAGTCAAGGCTTT->ACCGGTAGTCAAGGCTTTA
AGGATACATACAGGAGTAA->GGATACATACAGGAGTAAA
TTGAGATACTCCTACTTGA->TGAGATACTCCTACTTGAA
CTGGAGGATATTCGTAAGC->TGGAGGATATTCGTAAGCC
GGGATAGCACCCTCCTCAA->GGATAGCACCCTCCTCAAC
GAGTAGTCACCGCTCTCTA->AGTAGTCACCGCTCTCTAG
GGGCTAACCTGGCGGCTGG->GGCTAACCTGGCGGCTGGG
GGCTAACCTGGCGGCTGGG->GCTAACCTGGCGGCTGGGA
TCAGTTCCCCAACGAGAGG->CAGTTCCCCAACGAGAGGA
AAGTACTCTGATGTTCGCA->AGTACTCTGATGTTCGCAA
GGACCCTCCGAATTTCAGG->GACCCTCCGAATTTCAGGC
GACCCTCCGAATTTCAGGC->ACCCTCCGAATTTCAGGCC
ATTTCAGGCCGGGACGCGT->TTTCAGGCCGGGACGCGTT
CCATACTCAGCTGTATTCA->CATACTCAGCTGTATTCAG
TCGAAGTAACCCACTCAGA->CGAAGTAACCCACTCAGAT
AAGATAAGTCAAAGCCTGG->AGATAAGTCAAAGCCTGGG
GGTAGTCAAGGCTTTAACC->GTAGTCAAGGCTTTAACCA
GGTAGGAAGCGAATTATAG->GTAGGAAGCGAATTATAGT
GGATAGCACCCTCCTCAAC->GATAGCACCCTCCTCAACG
CGTCGCACTGGAGCAGGTT->GTCGCACTGGAGCAGGTTA
CAGCGCCGTATTCAGGACC->AGCGCCGTATTCAGGACCC
GAGAAAAGCCGTTCAAAAA->AGAAAAGCCGTTCAAAAAG
TGCACAGGCCCGATTGCCA->GCACAGGCCCGATTGCCAG
CCGAATTTCAGGCCGGGAC->CGAATTTCAGGCCGGGACG
GCTAACCTGGCGGCTGGGA->CTAACCTGGCGGCTGGGAT
TTCGCAAAATGGACTCGCT->TCGCAAAATGGACTCGCTC
TCCTGTGGGCGGTCTTGCT->CCTGTGGGCGGTCTTGCTA
CTCTTATTTTTAGAATTGA->TCTTATTTTTAGAATTGAG
CCCGATCTGTCTAGAATAA->CCGATCTGTCTAGAATAAA
CGCCGTATTCAGGACCCTC->GCCGTATTCAGGACCCTCC
CAGAATTCCCGTCAAGTAC->AGAATTCCCGTCAAGTACT
ATAACGAACGCGTATTCAG->TAACGAACGCGTATTCAGG
AGGTCACGGCGCAGATCAT->GGTCACGGCGCAGATCATT
GGTCACGGCGCAGATCATT->GTCACGGCGCAGATCATTC
CAACGAGAGGACGGTGTAT->AACGAGAGGACGGTGTATC
CTGATAGTCAACCTCCACG->TGATAGTCAACCTCCACGC
CGGGAGGAGAACCATGACT->GGGAGGAGAACCATGACTG
ACCAGTAGACAGTCGCAGC->CCAGTAGACAGTCGCAGCT
TGATCATCTACGCCATTTA->GATCATCTACGCCATTTAC
TTTGAACCATCTGCAAAGA->TTGAACCATCTGCAAAGAC
TCGTCGCACTGGAGCAGGT->CGTCGCACTGGAGCAGGTT
ATGTCACGATTCTTACCTA->TGTCACGATTCTTACCTAT
CAAGGGGTCTGGACTCTAT->AAGGGGTCTGGACTCTATT
TATAGCTAATGCGAGTACC->ATAGCTAATGCGAGTACCC
GCCCGCGGTTGAGTAACGG->CCCGCGGTTGAGTAACGGC
AACGCGACGAGCCAACACC->ACGCGACGAGCCAACACCC
TCAAGCCACTCCAATTTAT->CAAGCCACTCCAATTTATT
TACGTGCTGAAGACTTTAC->ACGTGCTGAAGACTTTACT
ATGCAGGGGCACATAATTT->TGCAGGGGCACATAATTTT
CTTAGGACATGTCGTCGCG->TTAGGACATGTCGTCGCGC
AGACCGTCCTGTGGGCGGT->GACCGTCCTGTGGGCGGTC
ACAGGCCCGATTGCCAGGA->CAGGCCCGATTGCCAGGAA
GTAAAAGCCTGGGTACCTT->TAAAAGCCTGGGTACCTTC
ACCCTCCGAATTTCAGGCC->CCCTCCGAATTTCAGGCCG
TAGGATACATACAGGAGTA->AGGATACATACAGGAGTAA
GTCACGGCGCAGATCATTC->TCACGGCGCAGATCATTCC
AGTGTCTCAGGGATTTCTT->GTGTCTCAGGGATTTCTTG
AGACCCCTAACCTAGGTGT->GACCCCTAACCTAGGTGTT
ACCGGTAGTCAAGGCTTTA->CCGGTAGTCAAGGCTTTAA
CACGATTCTTACCTATGGT->ACGATTCTTACCTATGGTT
ATGTCGTCGCGCCGAGGGC->TGTCGTCGCGCCGAGGGCG
ACTGTCGGGAGGAGAACCA->CTGTCGGGAGGAGAACCAT
TGGGTACCTTCCCATACTC->GGGTACCTTCCCATACTCA
TGGAATATGCCTCGATCAA->GGAATATGCCTCGATCAAG
AACTGTCGGGAGGAGAACC->ACTGTCGGGAGGAGAACCA
CGCGCCGAGGGCGCAGTAG->GCGCCGAGGGCGCAGTAGT
GCATCATTAAGCATAAGCA->CATCATTAAGCATAAGCAG
GACCGTCCTGTGGGCGGTC->ACCGTCCTGTGGGCGGTCT
ATTTACCGTTCCATGTCGA->TTTACCGTTCCATGTCGAC
GGCGATCCTGTGGCCCTAG->GCGATCCTGTGGCCCTAGC
CGGGTACCGGTAGTCAAGG->GGGTACCGGTAGTCAAGGC
CCTAGGTGTTTTAGCAATA->CTAGGTGTTTTAGCAATAG
TTACTAACTGTCGGGAGGA->TACTAACTGTCGGGAGGAG
GATCCGAACGCGACGAGCC->ATCCGAACGCGACGAGCCA
AATCCCTAGCCTAAATGTC->ATCCCTAGCCTAAATGTCT
ACGGTGTATCCGCCCTCAC->CGGTGTATCCGCCCTCACG
GCCTTGGCTCAGTTCCCCA->CCTTGGCTCAGTTCCCCAA
AGCCTTGGCTCAGTTCCCC->GCCTTGGCTCAGTTCCCCA
CGGTGTATCCGCCCTCACG->GGTGTATCCGCCCTCACGC
GGTGTATCCGCCCTCACGC->GTGTATCCGCCCTCACGCT
GCTTAGATGCATCATTAAG->CTTAGATGCATCATTAAGC
CGGATGACTCTTGGTTAGT->GGATGACTCTTGGTTAGTT
GGATGACTCTTGGTTAGTT->GATGACTCTTGGTTAGTTT
TAACGAACGCGTATTCAGG->AACGAACGCGTATTCAGGA
ACCGTCCTGTGGGCGGTCT->CCGTCCTGTGGGCGGTCTT
GAGGAGAACCATGACTGCC->AGGAGAACCATGACTGCCC
TCGCAAAATGGACTCGCTC->CGCAAAATGGACTCGCTCC
CGAGAGGCCCTGTAAAATC->GAGAGGCCCTGTAAAATCA
CAGTAGTGCCGGGTACCGG->AGTAGTGCCGGGTACCGGT
GATACTCCTACTTGAAAGC->ATACTCCTACTTGAAAGCC
ACTAAGACACCTAACTATC->CTAAGACACCTAACTATCA
TAATTGTGGGAGGCGATCC->AATTGTGGGAGGCGATCCT
AACCTGTAAACGTCCTTGA->ACCTGTAAACGTCCTTGAC
AGGCCCTGTAAAATCATCA->GGCCCTGTAAAATCATCAC
CGCGCCTCTTATTTTTAGA->GCGCCTCTTATTTTTAGAA
TGACTCAAGGGGTCTGGAC->GACTCAAGGGGTCTGGACT
GACTCAAGGGGTCTGGACT->ACTCAAGGGGTCTGGACTC
GCCCATCGCGCCTTTGACG->CCCATCGCGCCTTTGACGG
GAGTAATTCACGTCACCGG->AGTAATTCACGTCACCGGG
CCGTCAAGTACTCTGATGT->CGTCAAGTACTCTGATGTT
ATAGGATACATACAGGAGT->TAGGATACATACAGGAGTA
GTACCTTCCCATACTCAGC->TACCTTCCCATACTCAGCT
CTCAGCTGTATTCAGGACC->TCAGCTGTATTCAGGACCC
GTGCTGGAGGATATTCGTA->TGCTGGAGGATATTCGTAA
CCAACGAGAGGACGGTGTA->CAACGAGAGGACGGTGTAT
ATCAGTTTTGAAACGAGGG->TCAGTTTTGAAACGAGGGA
TTATAGCTAATGCGAGTAC->TATAGCTAATGCGAGTACC
GTATAGTATTCAAGCCACT->TATAGTATTCAAGCCACTC
CTGCGTCAGTAAGATAAGT->TGCGTCAGTAAGATAAGTC
CCTGCACATCAGCAGCTGG->CTGCACATCAGCAGCTGGG
ACCTTCCGATACAGCGCCG->CCTTCCGATACAGCGCCGT
CCTTCCGATACAGCGCCGT->CTTCCGATACAGCGCCGTA
TTGGTTAGTTTTTCAGCCT->TGGTTAGTTTTTCAGCCTC
CGTTATACCTATTCGTTGG->GTTATACCTATTCGTTGGG
ATGCGTGGCAGCATCCCAA->TGCGTGGCAGCATCCCAAC
AATTCCCGTCAAGTACTCT->ATTCCCGTCAAGTACTCTG
CAGTGTCTCAGGGATTTCT->AGTGTCTCAGGGATTTCTT
ACCGTTCCATGTCGACCCA->CCGTTCCATGTCGACCCAC
GAAAGCCTGGGTACCTTCC->AAAGCCTGGGTACCTTCCG
AAAGCCTGGGTACCTTCCG->AAGCCTGGGTACCTTCCGA
TTACCTATGGTTTTACGTC->TACCTATGGTTTTACGTCA
ACTCAAGGGGTCTGGACTC->CTCAAGGGGTCTGGACTCT
CAATTTATTCAATAACGTA->AATTTATTCAATAACGTAA
ACGTCAGCGACTCAGCAGA->CGTCAGCGACTCAGCAGAA
CTAACGAGACGGTTCCGTG->TAACGAGACGGTTCCGTGG
GCAGAATTCCCGTCAAGTA->CAGAATTCCCGTCAAGTAC
ATGCCTCGATCAAGACAGT->TGCCTCGATCAAGACAGTT
TAGCCTAAATGTCTCAGTA->AGCCTAAATGTCTCAGTAT
AATTATAGTAGAGGCCCGC->ATTATAGTAGAGGCCCGCG
GTATGAGGTCCCCGCAAAA->TATGAGGTCCCCGCAAAAT
GGCCTGTCGAAGTAACCCA->GCCTGTCGAAGTAACCCAC
TTACCTTCAAGAGTAGTCA->TACCTTCAAGAGTAGTCAC
AAGGTCACGGCGCAGATCA->AGGTCACGGCGCAGATCAT
CATACTCAGCTGTATTCAG->ATACTCAGCTGTATTCAGG
TACCGTTCCATGTCGACCC->ACCGTTCCATGTCGACCCA
TGCGTCAGTAAGATAAGTC->GCGTCAGTAAGATAAGTCA
ATGGACGATGTCGCATCGG->TGGACGATGTCGCATCGGG
AGCAGAATTCCCGTCAAGT->GCAGAATTCCCGTCAAGTA
CTAATTGTGGGAGGCGATC->TAATTGTGGGAGGCGATCC
