AGGCAGGGGTT->GGCAGGGGTTA
GGCAGGGGTTA->GCAGGGGTTAG
GCAGGGGTTAG->CAGGGGTTAGG
CAGGGGTTAGG->AGGGGTTAGGT
AGGGGTTAGGT->GGGGTTAGGTC
GGGGTTAGGTC->GGGTTAGGTCA
GGGTTAGGTCA->GGTTAGGTCAC
GGTTAGGTCAC->GTTAGGTCACG
GTTAGGTCACG->TTAGGTCACGC
TTAGGTCACGC->TAGGTCACGCT
TAGGTCACGCT->AGGTCACGCTT
AGGTCACGCTT->GGTCACGCTTA
GGTCACGCTTA->GTCACGCTTAG
GTCACGCTTAG->TCACGCTTAGC
TCACGCTTAGC->CACGCTTAGCT
CACGCTTAGCT->ACGCTTAGCTG
ACGCTTAGCTG->CGCTTAGCTGG
CGCTTAGCTGG->GCTTAGCTGGG
GCTTAGCTGGG->CTTAGCTGGGG
CTTAGCTGGGG->TTAGCTGGGGA
TTAGCTGGGGA->TAGCTGGGGAC
TAGCTGGGGAC->AGCTGGGGACT
AGCTGGGGACT->GCTGGGGACTT
GCTGGGGACTT->CTGGGGACTTA
CTGGGGACTTA->TGGGGACTTAA
TGGGGACTTAA->GGGGACTTAAA
GGGGACTTAAA->GGGACTTAAAT
GGGACTTAAAT->GGACTTAAATT
GGACTTAAATT->GACTTAAATTC
GACTTAAATTC->ACTTAAATTCC
ACTTAAATTCC->CTTAAATTCCT
CTTAAATTCCT->TTAAATTCCTT
TTAAATTCCTT->TAAATTCCTTG
TAAATTCCTTG->AAATTCCTTGA
AAATTCCTTGA->AATTCCTTGAA
AATTCCTTGAA->ATTCCTTGAAA
ATTCCTTGAAA->TTCCTTGAAAG
TTCCTTGAAAG->TCCTTGAAAGT
TCCTTGAAAGT->CCTTGAAAGTC
CCTTGAAAGTC->CTTGAAAGTCG
CTTGAAAGTCG->TTGAAAGTCGC
TTGAAAGTCGC->TGAAAGTCGCG
TGAAAGTCGCG->GAAAGTCGCGT
GAAAGTCGCGT->AAAGTCGCGTC
AAAGTCGCGTC->AAGTCGCGTCT
AAGTCGCGTCT->AGTCGCGTCTA
AGTCGCGTCTA->GTCGCGTCTAA
GTCGCGTCTAA->TCGCGTCTAAT
TCGCGTCTAAT->CGCGTCTAATC
CGCGTCTAATC->GCGTCTAATCC
GCGTCTAATCC->CGTCTAATCCT
CGTCTAATCCT->GTCTAATCCTT
GTCTAATCCTT->TCTAATCCTTC
TCTAATCCTTC->CTAATCCTTCT
CTAATCCTTCT->TAATCCTTCTC
TAATCCTTCTC->AATCCTTCTCG
AATCCTTCTCG->ATCCTTCTCGA
ATCCTTCTCGA->TCCTTCTCGAA
TCCTTCTCGAA->CCTTCTCGAAG
CCTTCTCGAAG->CTTCTCGAAGT
CTTCTCGAAGT->TTCTCGAAGTA
TTCTCGAAGTA->TCTCGAAGTAG
TCTCGAAGTAG->CTCGAAGTAGA
CTCGAAGTAGA->TCGAAGTAGAA
TCGAAGTAGAA->CGAAGTAGAAA
CGAAGTAGAAA->GAAGTAGAAAT
GAAGTAGAAAT->AAGTAGAAATG
AAGTAGAAATG->AGTAGAAATGA
AGTAGAAATGA->GTAGAAATGAA
GTAGAAATGAA->TAGAAATGAAA
TAGAAATGAAA->AGAAATGAAAA
AGAAATGAAAA->GAAATGAAAAG
GAAATGAAAAG->AAATGAAAAGC
AAATGAAAAGC->AATGAAAAGCG
AATGAAAAGCG->ATGAAAAGCGT
ATGAAAAGCGT->TGAAAAGCGTT
TGAAAAGCGTT->GAAAAGCGTTG
GAAAAGCGTTG->AAAAGCGTTGT
AAAAGCGTTGT->AAAGCGTTGTC
AAAGCGTTGTC->AAGCGTTGTCC
AAGCGTTGTCC->AGCGTTGTCCG
AGCGTTGTCCG->GCGTTGTCCGT
GCGTTGTCCGT->CGTTGTCCGTG
CGTTGTCCGTG->GTTGTCCGTGG
GTTGTCCGTGG->TTGTCCGTGGC
TTGTCCGTGGC->TGTCCGTGGCC
TGTCCGTGGCC->GTCCGTGGCCA
GTCCGTGGCCA->TCCGTGGCCAA
TCCGTGGCCAA->CCGTGGCCAAA
CCGTGGCCAAA->CGTGGCCAAAA
CGTGGCCAAAA->GTGGCCAAAAC
GTGGCCAAAAC->TGGCCAAAACA
TGGCCAAAACA->GGCCAAAACAC
GGCCAAAACAC->GCCAAAACACG
GCCAAAACACG->CCAAAACACGG
CCAAAACACGG->CAAAACACGGC
CAAAACACGGC->AAAACACGGCA
AAAACACGGCA->AAACACGGCAG
AAACACGGCAG->AACACGGCAGG
AACACGGCAGG->ACACGGCAGGA
ACACGGCAGGA->CACGGCAGGAA
CACGGCAGGAA->ACGGCAGGAAG
ACGGCAGGAAG->CGGCAGGAAGC
CGGCAGGAAGC->GGCAGGAAGCA
GGCAGGAAGCA->GCAGGAAGCAA
GCAGGAAGCAA->CAGGAAGCAAT
CAGGAAGCAAT->AGGAAGCAATC
AGGAAGCAATC->GGAAGCAATCT
GGAAGCAATCT->GAAGCAATCTG
GAAGCAATCTG->AAGCAATCTGA
AAGCAATCTGA->AGCAATCTGAT
AGCAATCTGAT->GCAATCTGATC
GCAATCTGATC->CAATCTGATCC
CAATCTGATCC->AATCTGATCCC
AATCTGATCCC->ATCTGATCCCT
ATCTGATCCCT->TCTGATCCCTA
TCTGATCCCTA->CTGATCCCTAC
CTGATCCCTAC->TGATCCCTACA
TGATCCCTACA->GATCCCTACAC
GATCCCTACAC->ATCCCTACACG
ATCCCTACACG->TCCCTACACGA
TCCCTACACGA->CCCTACACGAC
CCCTACACGAC->CCTACACGACA
CCTACACGACA->CTACACGACAC
CTACACGACAC->TACACGACACA
TACACGACACA->ACACGACACAC
ACACGACACAC->CACGACACACA
CACGACACACA->ACGACACACAT
ACGACACACAT->CGACACACATT
CGACACACATT->GACACACATTA
GACACACATTA->ACACACATTAA
ACACACATTAA->CACACATTAAC
CACACATTAAC->ACACATTAACC
ACACATTAACC->CACATTAACCC
CACATTAACCC->ACATTAACCCT
ACATTAACCCT->CATTAACCCTC
CATTAACCCTC->ATTAACCCTCC
ATTAACCCTCC->TTAACCCTCCC
TTAACCCTCCC->TAACCCTCCCA
TAACCCTCCCA->AACCCTCCCAA
AACCCTCCCAA->ACCCTCCCAAA
ACCCTCCCAAA->CCCTCCCAAAC
CCCTCCCAAAC->CCTCCCAAACG
CCTCCCAAACG->CTCCCAAACGT
CTCCCAAACGT->TCCCAAACGTG
TCCCAAACGTG->CCCAAACGTGT
CCCAAACGTGT->CCAAACGTGTC
CCAAACGTGTC->CAAACGTGTCT
CAAACGTGTCT->AAACGTGTCTC
AAACGTGTCTC->AACGTGTCTCA
AACGTGTCTCA->ACGTGTCTCAA
ACGTGTCTCAA->CGTGTCTCAAT
CGTGTCTCAAT->GTGTCTCAATC
GTGTCTCAATC->TGTCTCAATCG
TGTCTCAATCG->GTCTCAATCGG
GTCTCAATCGG->TCTCAATCGGG
TCTCAATCGGG->CTCAATCGGGA
CTCAATCGGGA->TCAATCGGGAC
TCAATCGGGAC->CAATCGGGACA
CAATCGGGACA->AATCGGGACAA
AATCGGGACAA->ATCGGGACAAC
ATCGGGACAAC->TCGGGACAACG
TCGGGACAACG->CGGGACAACGC
CGGGACAACGC->GGGACAACGCC
GGGACAACGCC->GGACAACGCCG
GGACAACGCCG->GACAACGCCGA
GACAACGCCGA->ACAACGCCGAC
ACAACGCCGAC->CAACGCCGACG
CAACGCCGACG->AACGCCGACGA
AACGCCGACGA->ACGCCGACGAG
ACGCCGACGAG->CGCCGACGAGG
CGCCGACGAGG->GCCGACGAGGA
GCCGACGAGGA->CCGACGAGGAC
CCGACGAGGAC->CGACGAGGACG
CGACGAGGACG->GACGAGGACGA
GACGAGGACGA->ACGAGGACGAC
ACGAGGACGAC->CGAGGACGACT
CGAGGACGACT->GAGGACGACTC
GAGGACGACTC->AGGACGACTCC
AGGACGACTCC->GGACGACTCCC
GGACGACTCCC->GACGACTCCCA
GACGACTCCCA->ACGACTCCCAG
ACGACTCCCAG->CGACTCCCAGC
CGACTCCCAGC->GACTCCCAGCG
GACTCCCAGCG->ACTCCCAGCGG
ACTCCCAGCGG->CTCCCAGCGGC
CTCCCAGCGGC->TCCCAGCGGCG
TCCCAGCGGCG->CCCAGCGGCGC
CCCAGCGGCGC->CCAGCGGCGCA
CCAGCGGCGCA->CAGCGGCGCAC
CAGCGGCGCAC->AGCGGCGCACG
AGCGGCGCACG->GCGGCGCACGC
GCGGCGCACGC->CGGCGCACGCA
CGGCGCACGCA->GGCGCACGCAC
GGCGCACGCAC->GCGCACGCACC
GCGCACGCACC->CGCACGCACCA
CGCACGCACCA->GCACGCACCAG
GCACGCACCAG->CACGCACCAGC
CACGCACCAGC->ACGCACCAGCT
ACGCACCAGCT->CGCACCAGCTT
CGCACCAGCTT->GCACCAGCTTT
GCACCAGCTTT->CACCAGCTTTG
CACCAGCTTTG->ACCAGCTTTGT
ACCAGCTTTGT->CCAGCTTTGTG
CCAGCTTTGTG->CAGCTTTGTGA
CAGCTTTGTGA->AGCTTTGTGAG
AGCTTTGTGAG->GCTTTGTGAGG
GCTTTGTGAGG->CTTTGTGAGGG
CTTTGTGAGGG->TTTGTGAGGGA
TTTGTGAGGGA->TTGTGAGGGAC
TTGTGAGGGAC->TGTGAGGGACC
TGTGAGGGACC->GTGAGGGACCT
GTGAGGGACCT->TGAGGGACCTA
TGAGGGACCTA->GAGGGACCTAC
GAGGGACCTAC->AGGGACCTACA
AGGGACCTACA->GGGACCTACAC
GGGACCTACAC->GGACCTACACT
GGACCTACACT->GACCTACACTT
GACCTACACTT->ACCTACACTTC
ACCTACACTTC->CCTACACTTCC
CCTACACTTCC->CTACACTTCCG
CTACACTTCCG->TACACTTCCGG
TACACTTCCGG->ACACTTCCGGC
ACACTTCCGGC->CACTTCCGGCG
CACTTCCGGCG->ACTTCCGGCGC
ACTTCCGGCGC->CTTCCGGCGCG
CTTCCGGCGCG->TTCCGGCGCGA
TTCCGGCGCGA->TCCGGCGCGAT
TCCGGCGCGAT->CCGGCGCGATC
CCGGCGCGATC->CGGCGCGATCC
CGGCGCGATCC->GGCGCGATCCC
GGCGCGATCCC->GCGCGATCCCA
GCGCGATCCCA->CGCGATCCCAC
CGCGATCCCAC->GCGATCCCACT
GCGATCCCACT->CGATCCCACTG
CGATCCCACTG->GATCCCACTGC
GATCCCACTGC->ATCCCACTGCG
ATCCCACTGCG->TCCCACTGCGG
TCCCACTGCGG->CCCACTGCGGC
CCCACTGCGGC->CCACTGCGGCA
CCACTGCGGCA->CACTGCGGCAT
CACTGCGGCAT->ACTGCGGCATT
ACTGCGGCATT->CTGCGGCATTT
CTGCGGCATTT->TGCGGCATTTG
TGCGGCATTTG->GCGGCATTTGA
GCGGCATTTGA->CGGCATTTGAG
CGGCATTTGAG->GGCATTTGAGC
GGCATTTGAGC->GCATTTGAGCT
GCATTTGAGCT->CATTTGAGCTT
CATTTGAGCTT->ATTTGAGCTTG
ATTTGAGCTTG->TTTGAGCTTGT
TTTGAGCTTGT->TTGAGCTTGTT
TTGAGCTTGTT->TGAGCTTGTTT
TGAGCTTGTTT->GAGCTTGTTTG
GAGCTTGTTTG->AGCTTGTTTGC
AGCTTGTTTGC->GCTTGTTTGCG
GCTTGTTTGCG->CTTGTTTGCGA
CTTGTTTGCGA->TTGTTTGCGAA
TTGTTTGCGAA->TGTTTGCGAAG
TGTTTGCGAAG->GTTTGCGAAGG
GTTTGCGAAGG->TTTGCGAAGGG
TTTGCGAAGGG->TTGCGAAGGGG
TTGCGAAGGGG->TGCGAAGGGGA
TGCGAAGGGGA->GCGAAGGGGAT
GCGAAGGGGAT->CGAAGGGGATT
CGAAGGGGATT->GAAGGGGATTT
GAAGGGGATTT->AAGGGGATTTC
AAGGGGATTTC->AGGGGATTTCT
AGGGGATTTCT->GGGGATTTCTG
GGGGATTTCTG->GGGATTTCTGA
GGGATTTCTGA->GGATTTCTGAC
GGATTTCTGAC->GATTTCTGACG
GATTTCTGACG->ATTTCTGACGT
ATTTCTGACGT->TTTCTGACGTG
TTTCTGACGTG->TTCTGACGTGA
TTCTGACGTGA->TCTGACGTGAT
TCTGACGTGAT->CTGACGTGATA
CTGACGTGATA->TGACGTGATAA
TGACGTGATAA->GACGTGATAAT
GACGTGATAAT->ACGTGATAATC
ACGTGATAATC->CGTGATAATCG
CGTGATAATCG->GTGATAATCGA
GTGATAATCGA->TGATAATCGAC
TGATAATCGAC->GATAATCGACT
GATAATCGACT->ATAATCGACTA
ATAATCGACTA->TAATCGACTAT
TAATCGACTAT->AATCGACTATA
AATCGACTATA->ATCGACTATAC
ATCGACTATAC->TCGACTATACA
TCGACTATACA->CGACTATACAC
CGACTATACAC->GACTATACACA
GACTATACACA->ACTATACACAT
ACTATACACAT->CTATACACATG
CTATACACATG->TATACACATGG
TATACACATGG->ATACACATGGC
ATACACATGGC->TACACATGGCA
TACACATGGCA->ACACATGGCAT
ACACATGGCAT->CACATGGCATC
CACATGGCATC->ACATGGCATCT
ACATGGCATCT->CATGGCATCTA
CATGGCATCTA->ATGGCATCTAC
ATGGCATCTAC->TGGCATCTACT
TGGCATCTACT->GGCATCTACTG
GGCATCTACTG->GCATCTACTGC
GCATCTACTGC->CATCTACTGCA
CATCTACTGCA->ATCTACTGCAA
ATCTACTGCAA->TCTACTGCAAA
TCTACTGCAAA->CTACTGCAAAC
CTACTGCAAAC->TACTGCAAACC
TACTGCAAACC->ACTGCAAACCC
ACTGCAAACCC->CTGCAAACCCC
CTGCAAACCCC->TGCAAACCCCA
TGCAAACCCCA->GCAAACCCCAA
GCAAACCCCAA->CAAACCCCAAT
CAAACCCCAAT->AAACCCCAATG
AAACCCCAATG->AACCCCAATGC
AACCCCAATGC->ACCCCAATGCG
ACCCCAATGCG->CCCCAATGCGG
CCCCAATGCGG->CCCAATGCGGC
CCCAATGCGGC->CCAATGCGGCG
CCAATGCGGCG->CAATGCGGCGT
CAATGCGGCGT->AATGCGGCGTT
AATGCGGCGTT->ATGCGGCGTTC
ATGCGGCGTTC->TGCGGCGTTCC
TGCGGCGTTCC->GCGGCGTTCCT
GCGGCGTTCCT->CGGCGTTCCTG
CGGCGTTCCTG->GGCGTTCCTGA
GGCGTTCCTGA->GCGTTCCTGAC
GCGTTCCTGAC->CGTTCCTGACC
CGTTCCTGACC->GTTCCTGACCT
GTTCCTGACCT->TTCCTGACCTG
TTCCTGACCTG->TCCTGACCTGT
TCCTGACCTGT->CCTGACCTGTA
CCTGACCTGTA->CTGACCTGTAC
CTGACCTGTAC->TGACCTGTACC
TGACCTGTACC->GACCTGTACCC
GACCTGTACCC->ACCTGTACCCG
ACCTGTACCCG->CCTGTACCCGA
CCTGTACCCGA->CTGTACCCGAG
CTGTACCCGAG->TGTACCCGAGA
TGTACCCGAGA->GTACCCGAGAC
GTACCCGAGAC->TACCCGAGACG
TACCCGAGACG->ACCCGAGACGG
ACCCGAGACGG->CCCGAGACGGG
CCCGAGACGGG->CCGAGACGGGA
CCGAGACGGGA->CGAGACGGGAG
CGAGACGGGAG->GAGACGGGAGT
GAGACGGGAGT->AGACGGGAGTA
AGACGGGAGTA->GACGGGAGTAC
GACGGGAGTAC->ACGGGAGTACA
ACGGGAGTACA->CGGGAGTACAC
CGGGAGTACAC->GGGAGTACACG
GGGAGTACACG->GGAGTACACGG
GGAGTACACGG->GAGTACACGGA
GAGTACACGGA->AGTACACGGAA
AGTACACGGAA->GTACACGGAAG
GTACACGGAAG->TACACGGAAGC
TACACGGAAGC->ACACGGAAGCA
ACACGGAAGCA->CACGGAAGCAT
CACGGAAGCAT->ACGGAAGCATA
ACGGAAGCATA->CGGAAGCATAA
CGGAAGCATAA->GGAAGCATAAA
GGAAGCATAAA->GAAGCATAAAT
GAAGCATAAAT->AAGCATAAATT
AAGCATAAATT->AGCATAAATTG
AGCATAAATTG->GCATAAATTGC
GCATAAATTGC->CATAAATTGCT
CATAAATTGCT->ATAAATTGCTC
ATAAATTGCTC->TAAATTGCTCC
TAAATTGCTCC->AAATTGCTCCC
AAATTGCTCCC->AATTGCTCCCC
AATTGCTCCCC->ATTGCTCCCCC
ATTGCTCCCCC->TTGCTCCCCCC
TTGCTCCCCCC->TGCTCCCCCCG
TGCTCCCCCCG->GCTCCCCCCGA
GCTCCCCCCGA->CTCCCCCCGAG
CTCCCCCCGAG->TCCCCCCGAGG
TCCCCCCGAGG->CCCCCCGAGGG
CCCCCCGAGGG->CCCCCGAGGGA
CCCCCGAGGGA->CCCCGAGGGAA
CCCCGAGGGAA->CCCGAGGGAAG
CCCGAGGGAAG->CCGAGGGAAGA
CCGAGGGAAGA->CGAGGGAAGAA
CGAGGGAAGAA->GAGGGAAGAAA
GAGGGAAGAAA->AGGGAAGAAAA
AGGGAAGAAAA->GGGAAGAAAAC
GGGAAGAAAAC->GGAAGAAAACA
GGAAGAAAACA->GAAGAAAACAA
GAAGAAAACAA->AAGAAAACAAA
AAGAAAACAAA->AGAAAACAAAG
AGAAAACAAAG->GAAAACAAAGG
GAAAACAAAGG->AAAACAAAGGG
AAAACAAAGGG->AAACAAAGGGG
AAACAAAGGGG->AACAAAGGGGG
AACAAAGGGGG->ACAAAGGGGGG
ACAAAGGGGGG->CAAAGGGGGGG
CAAAGGGGGGG->AAAGGGGGGGT
AAAGGGGGGGT->AAGGGGGGGTC
AAGGGGGGGTC->AGGGGGGGTCC
AGGGGGGGTCC->GGGGGGGTCCA
GGGGGGGTCCA->GGGGGGTCCAC
GGGGGGTCCAC->GGGGGTCCACT
GGGGGTCCACT->GGGGTCCACTA
GGGGTCCACTA->GGGTCCACTAA
GGGTCCACTAA->GGTCCACTAAT
GGTCCACTAAT->GTCCACTAATA
GTCCACTAATA->TCCACTAATAG
TCCACTAATAG->CCACTAATAGC
CCACTAATAGC->CACTAATAGCA
CACTAATAGCA->ACTAATAGCAG
ACTAATAGCAG->CTAATAGCAGT
CTAATAGCAGT->TAATAGCAGTA
TAATAGCAGTA->AATAGCAGTAA
AATAGCAGTAA->ATAGCAGTAAT
ATAGCAGTAAT->TAGCAGTAATG
TAGCAGTAATG->AGCAGTAATGG
AGCAGTAATGG->GCAGTAATGGT
GCAGTAATGGT->CAGTAATGGTA
CAGTAATGGTA->AGTAATGGTAG
AGTAATGGTAG->GTAATGGTAGT
GTAATGGTAGT->TAATGGTAGTT
TAATGGTAGTT->AATGGTAGTTG
AATGGTAGTTG->ATGGTAGTTGG
ATGGTAGTTGG->TGGTAGTTGGT
TGGTAGTTGGT->GGTAGTTGGTA
GGTAGTTGGTA->GTAGTTGGTAT
GTAGTTGGTAT->TAGTTGGTATG
TAGTTGGTATG->AGTTGGTATGG
AGTTGGTATGG->GTTGGTATGGG
GTTGGTATGGG->TTGGTATGGGA
TTGGTATGGGA->TGGTATGGGAC
TGGTATGGGAC->GGTATGGGACT
GGTATGGGACT->GTATGGGACTT
GTATGGGACTT->TATGGGACTTC
TATGGGACTTC->ATGGGACTTCC
ATGGGACTTCC->TGGGACTTCCA
TGGGACTTCCA->GGGACTTCCAA
GGGACTTCCAA->GGACTTCCAAT
GGACTTCCAAT->GACTTCCAATA
GACTTCCAATA->ACTTCCAATAC
ACTTCCAATAC->CTTCCAATACC
CTTCCAATACC->TTCCAATACCA
TTCCAATACCA->TCCAATACCAC
TCCAATACCAC->CCAATACCACT
CCAATACCACT->CAATACCACTG
CAATACCACTG->AATACCACTGA
AATACCACTGA->ATACCACTGAG
ATACCACTGAG->TACCACTGAGA
TACCACTGAGA->ACCACTGAGAA
ACCACTGAGAA->CCACTGAGAAA
CCACTGAGAAA->CACTGAGAAAG
CACTGAGAAAG->ACTGAGAAAGT
ACTGAGAAAGT->CTGAGAAAGTA
CTGAGAAAGTA->TGAGAAAGTAC
TGAGAAAGTAC->GAGAAAGTACG
GAGAAAGTACG->AGAAAGTACGG
AGAAAGTACGG->GAAAGTACGGA
GAAAGTACGGA->AAAGTACGGAG
AAAGTACGGAG->AAGTACGGAGC
AAGTACGGAGC->AGTACGGAGCT
AGTACGGAGCT->GTACGGAGCTC
GTACGGAGCTC->TACGGAGCTCC
TACGGAGCTCC->ACGGAGCTCCT
ACGGAGCTCCT->CGGAGCTCCTA
CGGAGCTCCTA->GGAGCTCCTAA
GGAGCTCCTAA->GAGCTCCTAAT
GAGCTCCTAAT->AGCTCCTAATA
AGCTCCTAATA->GCTCCTAATAC
GCTCCTAATAC->CTCCTAATACC
CTCCTAATACC->TCCTAATACCA
TCCTAATACCA->CCTAATACCAT
CCTAATACCAT->CTAATACCATG
CTAATACCATG->TAATACCATGA
TAATACCATGA->AATACCATGAA
AATACCATGAA->ATACCATGAAT
ATACCATGAAT->TACCATGAATA
TACCATGAATA->ACCATGAATAT
ACCATGAATAT->CCATGAATATC
CCATGAATATC->CATGAATATCT
CATGAATATCT->ATGAATATCTT
ATGAATATCTT->TGAATATCTTA
TGAATATCTTA->GAATATCTTAC
GAATATCTTAC->AATATCTTACT
AATATCTTACT->ATATCTTACTT
ATATCTTACTT->TATCTTACTTT
TATCTTACTTT->ATCTTACTTTA
ATCTTACTTTA->TCTTACTTTAC
TCTTACTTTAC->CTTACTTTACG
CTTACTTTACG->TTACTTTACGC
TTACTTTACGC->TACTTTACGCA
TACTTTACGCA->ACTTTACGCAC
ACTTTACGCAC->CTTTACGCACT
CTTTACGCACT->TTTACGCACTC
TTTACGCACTC->TTACGCACTCC
TTACGCACTCC->TACGCACTCCC
TACGCACTCCC->ACGCACTCCCG
ACGCACTCCCG->CGCACTCCCGA
CGCACTCCCGA->GCACTCCCGAA
GCACTCCCGAA->CACTCCCGAAG
CACTCCCGAAG->ACTCCCGAAGT
ACTCCCGAAGT->CTCCCGAAGTT
CTCCCGAAGTT->TCCCGAAGTTA
TCCCGAAGTTA->CCCGAAGTTAG
CCCGAAGTTAG->CCGAAGTTAGA
CCGAAGTTAGA->CGAAGTTAGAT
CGAAGTTAGAT->GAAGTTAGATT
GAAGTTAGATT->AAGTTAGATTG
AAGTTAGATTG->AGTTAGATTGT
AGTTAGATTGT->GTTAGATTGTT
GTTAGATTGTT->TTAGATTGTTC
TTAGATTGTTC->TAGATTGTTCG
TAGATTGTTCG->AGATTGTTCGG
AGATTGTTCGG->GATTGTTCGGA
GATTGTTCGGA->ATTGTTCGGAG
ATTGTTCGGAG->TTGTTCGGAGG
TTGTTCGGAGG->TGTTCGGAGGC
TGTTCGGAGGC->GTTCGGAGGCC
GTTCGGAGGCC->TTCGGAGGCCT
TTCGGAGGCCT->TCGGAGGCCTT
TCGGAGGCCTT->CGGAGGCCTTG
CGGAGGCCTTG->GGAGGCCTTGC
GGAGGCCTTGC->GAGGCCTTGCT
GAGGCCTTGCT->AGGCCTTGCTG
AGGCCTTGCTG->GGCCTTGCTGA
GGCCTTGCTGA->GCCTTGCTGAG
GCCTTGCTGAG->CCTTGCTGAGG
CCTTGCTGAGG->CTTGCTGAGGT
CTTGCTGAGGT->TTGCTGAGGTA
TTGCTGAGGTA->TGCTGAGGTAG
TGCTGAGGTAG->GCTGAGGTAGA
GCTGAGGTAGA->CTGAGGTAGAA
CTGAGGTAGAA->TGAGGTAGAAC
TGAGGTAGAAC->GAGGTAGAACT
GAGGTAGAACT->AGGTAGAACTC
AGGTAGAACTC->GGTAGAACTCT
GGTAGAACTCT->GTAGAACTCTA
GTAGAACTCTA->TAGAACTCTAT
TAGAACTCTAT->AGAACTCTATC
AGAACTCTATC->GAACTCTATCG
GAACTCTATCG->AACTCTATCGG
AACTCTATCGG->ACTCTATCGGC
ACTCTATCGGC->CTCTATCGGCG
CTCTATCGGCG->TCTATCGGCGG
TCTATCGGCGG->CTATCGGCGGA
CTATCGGCGGA->TATCGGCGGAA
TATCGGCGGAA->ATCGGCGGAAG
ATCGGCGGAAG->TCGGCGGAAGA
TCGGCGGAAGA->CGGCGGAAGAA
CGGCGGAAGAA->GGCGGAAGAAG
GGCGGAAGAAG->GCGGAAGAAGA
GCGGAAGAAGA->CGGAAGAAGAT
CGGAAGAAGAT->GGAAGAAGATG
GGAAGAAGATG->GAAGAAGATGC
GAAGAAGATGC->AAGAAGATGCA
AAGAAGATGCA->AGAAGATGCAC
AGAAGATGCAC->GAAGATGCACA
GAAGATGCACA->AAGATGCACAG
AAGATGCACAG->AGATGCACAGG
AGATGCACAGG->GATGCACAGGT
GATGCACAGGT->ATGCACAGGTA
ATGCACAGGTA->TGCACAGGTAG
TGCACAGGTAG->GCACAGGTAGT
GCACAGGTAGT->CACAGGTAGTC
CACAGGTAGTC->ACAGGTAGTCA
ACAGGTAGTCA->CAGGTAGTCAA
CAGGTAGTCAA->AGGTAGTCAAT
AGGTAGTCAAT->GGTAGTCAATA
GGTAGTCAATA->GTAGTCAATAC
GTAGTCAATAC->TAGTCAATACC
TAGTCAATACC->AGTCAATACCG
AGTCAATACCG->GTCAATACCGT
GTCAATACCGT->TCAATACCGTT
TCAATACCGTT->CAATACCGTTT
CAATACCGTTT->AATACCGTTTA
AATACCGTTTA->ATACCGTTTAT
ATACCGTTTAT->TACCGTTTATA
TACCGTTTATA->ACCGTTTATAC
ACCGTTTATAC->CCGTTTATACG
CCGTTTATACG->CGTTTATACGA
CGTTTATACGA->GTTTATACGAG
GTTTATACGAG->TTTATACGAGA
TTTATACGAGA->TTATACGAGAA
TTATACGAGAA->TATACGAGAAA
TATACGAGAAA->ATACGAGAAAG
ATACGAGAAAG->TACGAGAAAGG
TACGAGAAAGG->ACGAGAAAGGA
ACGAGAAAGGA->CGAGAAAGGAA
CGAGAAAGGAA->GAGAAAGGAAT
GAGAAAGGAAT->AGAAAGGAATA
AGAAAGGAATA->GAAAGGAATAT
GAAAGGAATAT->AAAGGAATATT
AAAGGAATATT->AAGGAATATTA
AAGGAATATTA->AGGAATATTAC
AGGAATATTAC->GGAATATTACG
GGAATATTACG->GAATATTACGC
GAATATTACGC->AATATTACGCG
AATATTACGCG->ATATTACGCGT
ATATTACGCGT->TATTACGCGTC
TATTACGCGTC->ATTACGCGTCG
ATTACGCGTCG->TTACGCGTCGG
TTACGCGTCGG->TACGCGTCGGC
TACGCGTCGGC->ACGCGTCGGCG
ACGCGTCGGCG->CGCGTCGGCGG
CGCGTCGGCGG->GCGTCGGCGGG
GCGTCGGCGGG->CGTCGGCGGGC
CGTCGGCGGGC->GTCGGCGGGCC
GTCGGCGGGCC->TCGGCGGGCCC
TCGGCGGGCCC->CGGCGGGCCCC
CGGCGGGCCCC->GGCGGGCCCCC
GGCGGGCCCCC->GCGGGCCCCCT
GCGGGCCCCCT->CGGGCCCCCTT
CGGGCCCCCTT->GGGCCCCCTTT
GGGCCCCCTTT->GGCCCCCTTTC
GGCCCCCTTTC->GCCCCCTTTCG
GCCCCCTTTCG->CCCCCTTTCGA
CCCCCTTTCGA->CCCCTTTCGAC
CCCCTTTCGAC->CCCTTTCGACG
CCCTTTCGACG->CCTTTCGACGG
CCTTTCGACGG->CTTTCGACGGC
CTTTCGACGGC->TTTCGACGGCC
TTTCGACGGCC->TTCGACGGCCC
TTCGACGGCCC->TCGACGGCCCG
TCGACGGCCCG->CGACGGCCCGG
CGACGGCCCGG->GACGGCCCGGA
GACGGCCCGGA->ACGGCCCGGAT
ACGGCCCGGAT->CGGCCCGGATC
CGGCCCGGATC->GGCCCGGATCA
GGCCCGGATCA->GCCCGGATCAA
GCCCGGATCAA->CCCGGATCAAT
CCCGGATCAAT->CCGGATCAATT
CCGGATCAATT->CGGATCAATTA
CGGATCAATTA->GGATCAATTAC
GGATCAATTAC->GATCAATTACT
GATCAATTACT->ATCAATTACTT
ATCAATTACTT->TCAATTACTTG
TCAATTACTTG->CAATTACTTGC
CAATTACTTGC->AATTACTTGCC
AATTACTTGCC->ATTACTTGCCC
ATTACTTGCCC->TTACTTGCCCA
TTACTTGCCCA->TACTTGCCCAA
TACTTGCCCAA->ACTTGCCCAAG
ACTTGCCCAAG->CTTGCCCAAGA
CTTGCCCAAGA->TTGCCCAAGAC
TTGCCCAAGAC->TGCCCAAGACC
TGCCCAAGACC->GCCCAAGACCA
GCCCAAGACCA->CCCAAGACCAC
CCCAAGACCAC->CCAAGACCACT
CCAAGACCACT->CAAGACCACTC
CAAGACCACTC->AAGACCACTCC
AAGACCACTCC->AGACCACTCCG
AGACCACTCCG->GACCACTCCGG
GACCACTCCGG->ACCACTCCGGC
ACCACTCCGGC->CCACTCCGGCC
CCACTCCGGCC->CACTCCGGCCT
CACTCCGGCCT->ACTCCGGCCTG
ACTCCGGCCTG->CTCCGGCCTGT
CTCCGGCCTGT->TCCGGCCTGTG
TCCGGCCTGTG->CCGGCCTGTGA
CCGGCCTGTGA->CGGCCTGTGAA
CGGCCTGTGAA->GGCCTGTGAAA
GGCCTGTGAAA->GCCTGTGAAAG
GCCTGTGAAAG->CCTGTGAAAGA
CCTGTGAAAGA->CTGTGAAAGAA
CTGTGAAAGAA->TGTGAAAGAAG
TGTGAAAGAAG->GTGAAAGAAGG
GTGAAAGAAGG->TGAAAGAAGGA
TGAAAGAAGGA->GAAAGAAGGAC
GAAAGAAGGAC->AAAGAAGGACG
AAAGAAGGACG->AAGAAGGACGT
AAGAAGGACGT->AGAAGGACGTG
AGAAGGACGTG->GAAGGACGTGG
GAAGGACGTGG->AAGGACGTGGT
AAGGACGTGGT->AGGACGTGGTG
AGGACGTGGTG->GGACGTGGTGT
GGACGTGGTGT->GACGTGGTGTG
GACGTGGTGTG->ACGTGGTGTGG
ACGTGGTGTGG->CGTGGTGTGGG
CGTGGTGTGGG->GTGGTGTGGGA
GTGGTGTGGGA->TGGTGTGGGAC
TGGTGTGGGAC->GGTGTGGGACG
GGTGTGGGACG->GTGTGGGACGT
GTGTGGGACGT->TGTGGGACGTC
TGTGGGACGTC->GTGGGACGTCC
GTGGGACGTCC->TGGGACGTCCG
TGGGACGTCCG->GGGACGTCCGG
GGGACGTCCGG->GGACGTCCGGT
GGACGTCCGGT->GACGTCCGGTT
GACGTCCGGTT->ACGTCCGGTTG
ACGTCCGGTTG->CGTCCGGTTGT
CGTCCGGTTGT->GTCCGGTTGTG
GTCCGGTTGTG->TCCGGTTGTGG
TCCGGTTGTGG->CCGGTTGTGGG
CCGGTTGTGGG->CGGTTGTGGGG
CGGTTGTGGGG->GGTTGTGGGGG
GGTTGTGGGGG->GTTGTGGGGGT
GTTGTGGGGGT->TTGTGGGGGTT
TTGTGGGGGTT->TGTGGGGGTTT
TGTGGGGGTTT->GTGGGGGTTTA
GTGGGGGTTTA->TGGGGGTTTAG
TGGGGGTTTAG->GGGGGTTTAGA
GGGGGTTTAGA->GGGGTTTAGAT
GGGGTTTAGAT->GGGTTTAGATC
GGGTTTAGATC->GGTTTAGATCG
GGTTTAGATCG->GTTTAGATCGC
GTTTAGATCGC->TTTAGATCGCC
TTTAGATCGCC->TTAGATCGCCG
TTAGATCGCCG->TAGATCGCCGA
TAGATCGCCGA->AGATCGCCGAT
AGATCGCCGAT->GATCGCCGATT
GATCGCCGATT->ATCGCCGATTG
ATCGCCGATTG->TCGCCGATTGG
TCGCCGATTGG->CGCCGATTGGG
CGCCGATTGGG->GCCGATTGGGA
GCCGATTGGGA->CCGATTGGGAT
CCGATTGGGAT->CGATTGGGATA
CGATTGGGATA->GATTGGGATAA
GATTGGGATAA->ATTGGGATAAG
ATTGGGATAAG->TTGGGATAAGG
TTGGGATAAGG->TGGGATAAGGG
TGGGATAAGGG->GGGATAAGGGT
GGGATAAGGGT->GGATAAGGGTA
GGATAAGGGTA->GATAAGGGTAG
GATAAGGGTAG->ATAAGGGTAGC
ATAAGGGTAGC->TAAGGGTAGCG
TAAGGGTAGCG->AAGGGTAGCGA
AAGGGTAGCGA->AGGGTAGCGAG
AGGGTAGCGAG->GGGTAGCGAGC
GGGTAGCGAGC->GGTAGCGAGCC
GGTAGCGAGCC->GTAGCGAGCCA
GTAGCGAGCCA->TAGCGAGCCAG
TAGCGAGCCAG->AGCGAGCCAGT
AGCGAGCCAGT->GCGAGCCAGTT
GCGAGCCAGTT->CGAGCCAGTTC
CGAGCCAGTTC->GAGCCAGTTCC
GAGCCAGTTCC->AGCCAGTTCCA
AGCCAGTTCCA->GCCAGTTCCAA
GCCAGTTCCAA->CCAGTTCCAAG
CCAGTTCCAAG->CAGTTCCAAGC
CAGTTCCAAGC->AGTTCCAAGCT
AGTTCCAAGCT->GTTCCAAGCTC
GTTCCAAGCTC->TTCCAAGCTCT
TTCCAAGCTCT->TCCAAGCTCTC
TCCAAGCTCTC->CCAAGCTCTCC
CCAAGCTCTCC->CAAGCTCTCCG
CAAGCTCTCCG->AAGCTCTCCGT
AAGCTCTCCGT->AGCTCTCCGTA
AGCTCTCCGTA->GCTCTCCGTAG
GCTCTCCGTAG->CTCTCCGTAGC
CTCTCCGTAGC->TCTCCGTAGCC
TCTCCGTAGCC->CTCCGTAGCCA
CTCCGTAGCCA->TCCGTAGCCAT
TCCGTAGCCAT->CCGTAGCCATG
CCGTAGCCATG->CGTAGCCATGC
CGTAGCCATGC->GTAGCCATGCA
GTAGCCATGCA->TAGCCATGCAT
TAGCCATGCAT->AGCCATGCATT
AGCCATGCATT->GCCATGCATTA
GCCATGCATTA->CCATGCATTAC
CCATGCATTAC->CATGCATTACC
CATGCATTACC->ATGCATTACCC
ATGCATTACCC->TGCATTACCCT
TGCATTACCCT->GCATTACCCTA
GCATTACCCTA->CATTACCCTAT
CATTACCCTAT->ATTACCCTATA
ATTACCCTATA->TTACCCTATAT
TTACCCTATAT->TACCCTATATA
TACCCTATATA->ACCCTATATAC
ACCCTATATAC->CCCTATATACA
CCCTATATACA->CCTATATACAG
CCTATATACAG->CTATATACAGT
CTATATACAGT->TATATACAGTA
TATATACAGTA->ATATACAGTAA
ATATACAGTAA->TATACAGTAAA
TATACAGTAAA->ATACAGTAAAC
ATACAGTAAAC->TACAGTAAACT
TACAGTAAACT->ACAGTAAACTT
ACAGTAAACTT->CAGTAAACTTT
CAGTAAACTTT->AGTAAACTTTT
AGTAAACTTTT->GTAAACTTTTA
GTAAACTTTTA->TAAACTTTTAT
TAAACTTTTAT->AAACTTTTATT
AAACTTTTATT->AACTTTTATTC
AACTTTTATTC->ACTTTTATTCC
ACTTTTATTCC->CTTTTATTCCG
CTTTTATTCCG->TTTTATTCCGA
TTTTATTCCGA->TTTATTCCGAT
TTTATTCCGAT->TTATTCCGATG
TTATTCCGATG->TATTCCGATGA
TATTCCGATGA->ATTCCGATGAC
ATTCCGATGAC->TTCCGATGACG
TTCCGATGACG->TCCGATGACGA
TCCGATGACGA->CCGATGACGAA
CCGATGACGAA->CGATGACGAAG
CGATGACGAAG->GATGACGAAGA
GATGACGAAGA->ATGACGAAGAA
ATGACGAAGAA->TGACGAAGAAT
TGACGAAGAAT->GACGAAGAATG
GACGAAGAATG->ACGAAGAATGC
ACGAAGAATGC->CGAAGAATGCG
CGAAGAATGCG->GAAGAATGCGT
GAAGAATGCGT->AAGAATGCGTA
AAGAATGCGTA->AGAATGCGTAT
AGAATGCGTAT->GAATGCGTATT
GAATGCGTATT->AATGCGTATTC
AATGCGTATTC->ATGCGTATTCT
ATGCGTATTCT->TGCGTATTCTG
TGCGTATTCTG->GCGTATTCTGG
GCGTATTCTGG->CGTATTCTGGA
CGTATTCTGGA->GTATTCTGGAC
GTATTCTGGAC->TATTCTGGACT
TATTCTGGACT->ATTCTGGACTT
ATTCTGGACTT->TTCTGGACTTA
TTCTGGACTTA->TCTGGACTTAC
TCTGGACTTAC->CTGGACTTACA
CTGGACTTACA->TGGACTTACAG
TGGACTTACAG->GGACTTACAGT
GGACTTACAGT->GACTTACAGTA
GACTTACAGTA->ACTTACAGTAC
ACTTACAGTAC->CTTACAGTACA
CTTACAGTACA->TTACAGTACAC
TTACAGTACAC->TACAGTACACT
TACAGTACACT->ACAGTACACTG
ACAGTACACTG->CAGTACACTGC
CAGTACACTGC->AGTACACTGCC
AGTACACTGCC->GTACACTGCCC
GTACACTGCCC->TACACTGCCCC
TACACTGCCCC->ACACTGCCCCC
ACACTGCCCCC->CACTGCCCCCT
CACTGCCCCCT->ACTGCCCCCTC
ACTGCCCCCTC->CTGCCCCCTCT
CTGCCCCCTCT->TGCCCCCTCTA
TGCCCCCTCTA->GCCCCCTCTAG
GCCCCCTCTAG->CCCCCTCTAGA
CCCCCTCTAGA->CCCCTCTAGAG
CCCCTCTAGAG->CCCTCTAGAGC
CCCTCTAGAGC->CCTCTAGAGCA
CCTCTAGAGCA->CTCTAGAGCAT
CTCTAGAGCAT->TCTAGAGCATC
TCTAGAGCATC->CTAGAGCATCT
CTAGAGCATCT->TAGAGCATCTA
TAGAGCATCTA->AGAGCATCTAC
AGAGCATCTAC->GAGCATCTACT
GAGCATCTACT->AGCATCTACTT
AGCATCTACTT->GCATCTACTTG
GCATCTACTTG->CATCTACTTGC
CATCTACTTGC->ATCTACTTGCA
ATCTACTTGCA->TCTACTTGCAG
TCTACTTGCAG->CTACTTGCAGA
CTACTTGCAGA->TACTTGCAGAC
TACTTGCAGAC->ACTTGCAGACA
ACTTGCAGACA->CTTGCAGACAA
CTTGCAGACAA->TTGCAGACAAT
TTGCAGACAAT->TGCAGACAATA
TGCAGACAATA->GCAGACAATAT
GCAGACAATAT->CAGACAATATC
CAGACAATATC->AGACAATATCC
AGACAATATCC->GACAATATCCG
GACAATATCCG->ACAATATCCGT
ACAATATCCGT->CAATATCCGTT
CAATATCCGTT->AATATCCGTTT
AATATCCGTTT->ATATCCGTTTA
ATATCCGTTTA->TATCCGTTTAT
TATCCGTTTAT->ATCCGTTTATA
ATCCGTTTATA->TCCGTTTATAG
TCCGTTTATAG->CCGTTTATAGT
CCGTTTATAGT->CGTTTATAGTA
CGTTTATAGTA->GTTTATAGTAC
GTTTATAGTAC->TTTATAGTACG
TTTATAGTACG->TTATAGTACGT
TTATAGTACGT->TATAGTACGTT
TATAGTACGTT->ATAGTACGTTA
ATAGTACGTTA->TAGTACGTTAG
TAGTACGTTAG->AGTACGTTAGG
AGTACGTTAGG->GTACGTTAGGG
GTACGTTAGGG->TACGTTAGGGA
TACGTTAGGGA->ACGTTAGGGAG
ACGTTAGGGAG->CGTTAGGGAGT
CGTTAGGGAGT->GTTAGGGAGTG
GTTAGGGAGTG->TTAGGGAGTGA
TTAGGGAGTGA->TAGGGAGTGAA
TAGGGAGTGAA->AGGGAGTGAAA
AGGGAGTGAAA->GGGAGTGAAAC
GGGAGTGAAAC->GGAGTGAAACG
GGAGTGAAACG->GAGTGAAACGG
GAGTGAAACGG->AGTGAAACGGG
AGTGAAACGGG->GTGAAACGGGG
GTGAAACGGGG->TGAAACGGGGC
TGAAACGGGGC->GAAACGGGGCA
GAAACGGGGCA->AAACGGGGCAG
AAACGGGGCAG->AACGGGGCAGT
AACGGGGCAGT->ACGGGGCAGTT
ACGGGGCAGTT->CGGGGCAGTTC
CGGGGCAGTTC->GGGGCAGTTCT
GGGGCAGTTCT->GGGCAGTTCTG
GGGCAGTTCTG->GGCAGTTCTGT
GGCAGTTCTGT->GCAGTTCTGTA
GCAGTTCTGTA->CAGTTCTGTAT
CAGTTCTGTAT->AGTTCTGTATG
AGTTCTGTATG->GTTCTGTATGC
GTTCTGTATGC->TTCTGTATGCC
TTCTGTATGCC->TCTGTATGCCC
TCTGTATGCCC->CTGTATGCCCG
CTGTATGCCCG->TGTATGCCCGG
TGTATGCCCGG->GTATGCCCGGG
GTATGCCCGGG->TATGCCCGGGT
TATGCCCGGGT->ATGCCCGGGTT
ATGCCCGGGTT->TGCCCGGGTTT
TGCCCGGGTTT->GCCCGGGTTTA
GCCCGGGTTTA->CCCGGGTTTAT
CCCGGGTTTAT->CCGGGTTTATT
CCGGGTTTATT->CGGGTTTATTG
CGGGTTTATTG->GGGTTTATTGA
GGGTTTATTGA->GGTTTATTGAT
GGTTTATTGAT->GTTTATTGATG
GTTTATTGATG->TTTATTGATGG
TTTATTGATGG->TTATTGATGGT
TTATTGATGGT->TATTGATGGTT
TATTGATGGTT->ATTGATGGTTG
ATTGATGGTTG->TTGATGGTTGT
TTGATGGTTGT->TGATGGTTGTA
TGATGGTTGTA->GATGGTTGTAT
GATGGTTGTAT->ATGGTTGTATC
ATGGTTGTATC->TGGTTGTATCA
TGGTTGTATCA->GGTTGTATCAC
GGTTGTATCAC->GTTGTATCACG
GTTGTATCACG->TTGTATCACGA
TTGTATCACGA->TGTATCACGAT
TGTATCACGAT->GTATCACGATA
GTATCACGATA->TATCACGATAC
TATCACGATAC->ATCACGATACG
ATCACGATACG->TCACGATACGC
TCACGATACGC->CACGATACGCT
CACGATACGCT->ACGATACGCTA
ACGATACGCTA->CGATACGCTAT
CGATACGCTAT->GATACGCTATA
GATACGCTATA->ATACGCTATAT
ATACGCTATAT->TACGCTATATG
TACGCTATATG->ACGCTATATGT
ACGCTATATGT->CGCTATATGTA
CGCTATATGTA->GCTATATGTAC
GCTATATGTAC->CTATATGTACG
CTATATGTACG->TATATGTACGA
TATATGTACGA->ATATGTACGAA
ATATGTACGAA->TATGTACGAAG
TATGTACGAAG->ATGTACGAAGT
ATGTACGAAGT->TGTACGAAGTA
TGTACGAAGTA->GTACGAAGTAC
GTACGAAGTAC->TACGAAGTACC
TACGAAGTACC->ACGAAGTACCA
ACGAAGTACCA->CGAAGTACCAA
CGAAGTACCAA->GAAGTACCAAC
GAAGTACCAAC->AAGTACCAACC
AAGTACCAACC->AGTACCAACCA
AGTACCAACCA->GTACCAACCAG
GTACCAACCAG->TACCAACCAGA
TACCAACCAGA->ACCAACCAGAC
ACCAACCAGAC->CCAACCAGACG
CCAACCAGACG->CAACCAGACGA
CAACCAGACGA->AACCAGACGAG
AACCAGACGAG->ACCAGACGAGA
ACCAGACGAGA->CCAGACGAGAA
CCAGACGAGAA->CAGACGAGAAC
CAGACGAGAAC->AGACGAGAACC
AGACGAGAACC->GACGAGAACCT
GACGAGAACCT->ACGAGAACCTC
ACGAGAACCTC->CGAGAACCTCG
CGAGAACCTCG->GAGAACCTCGT
GAGAACCTCGT->AGAACCTCGTT
AGAACCTCGTT->GAACCTCGTTA
GAACCTCGTTA->AACCTCGTTAT
AACCTCGTTAT->ACCTCGTTATG
ACCTCGTTATG->CCTCGTTATGA
CCTCGTTATGA->CTCGTTATGAA
CTCGTTATGAA->TCGTTATGAAG
TCGTTATGAAG->CGTTATGAAGG
CGTTATGAAGG->GTTATGAAGGG
GTTATGAAGGG->TTATGAAGGGA
TTATGAAGGGA->TATGAAGGGAC
TATGAAGGGAC->ATGAAGGGACG
ATGAAGGGACG->TGAAGGGACGT
TGAAGGGACGT->GAAGGGACGTT
GAAGGGACGTT->AAGGGACGTTT
AAGGGACGTTT->AGGGACGTTTG
AGGGACGTTTG->GGGACGTTTGT
GGGACGTTTGT->GGACGTTTGTC
GGACGTTTGTC->GACGTTTGTCT
GACGTTTGTCT->ACGTTTGTCTT
ACGTTTGTCTT->CGTTTGTCTTT
CGTTTGTCTTT->GTTTGTCTTTT
GTTTGTCTTTT->TTTGTCTTTTT
TTTGTCTTTTT->TTGTCTTTTTC
TTGTCTTTTTC->TGTCTTTTTCC
TGTCTTTTTCC->GTCTTTTTCCC
GTCTTTTTCCC->TCTTTTTCCCG
TCTTTTTCCCG->CTTTTTCCCGG
CTTTTTCCCGG->TTTTTCCCGGG
TTTTTCCCGGG->TTTTCCCGGGA
TTTTCCCGGGA->TTTCCCGGGAA
TTTCCCGGGAA->TTCCCGGGAAA
TTCCCGGGAAA->TCCCGGGAAAC
TCCCGGGAAAC->CCCGGGAAACG
CCCGGGAAACG->CCGGGAAACGT
CCGGGAAACGT->CGGGAAACGTC
CGGGAAACGTC->GGGAAACGTCG
GGGAAACGTCG->GGAAACGTCGT
GGAAACGTCGT->GAAACGTCGTT
GAAACGTCGTT->AAACGTCGTTT
AAACGTCGTTT->AACGTCGTTTA
AACGTCGTTTA->ACGTCGTTTAT
ACGTCGTTTAT->CGTCGTTTATA
CGTCGTTTATA->GTCGTTTATAG
GTCGTTTATAG->TCGTTTATAGG
TCGTTTATAGG->CGTTTATAGGA
CGTTTATAGGA->GTTTATAGGAG
GTTTATAGGAG->TTTATAGGAGA
TTTATAGGAGA->TTATAGGAGAG
TTATAGGAGAG->TATAGGAGAGC
TATAGGAGAGC->ATAGGAGAGCC
ATAGGAGAGCC->TAGGAGAGCCG
TAGGAGAGCCG->AGGAGAGCCGG
AGGAGAGCCGG->GGAGAGCCGGC
GGAGAGCCGGC->GAGAGCCGGCA
GAGAGCCGGCA->AGAGCCGGCAC
AGAGCCGGCAC->GAGCCGGCACC
GAGCCGGCACC->AGCCGGCACCT
AGCCGGCACCT->GCCGGCACCTT
GCCGGCACCTT->CCGGCACCTTG
CCGGCACCTTG->CGGCACCTTGC
CGGCACCTTGC->GGCACCTTGCG
GGCACCTTGCG->GCACCTTGCGA
GCACCTTGCGA->CACCTTGCGAG
CACCTTGCGAG->ACCTTGCGAGG
ACCTTGCGAGG->CCTTGCGAGGG
CCTTGCGAGGG->CTTGCGAGGGT
CTTGCGAGGGT->TTGCGAGGGTT
TTGCGAGGGTT->TGCGAGGGTTC
TGCGAGGGTTC->GCGAGGGTTCC
GCGAGGGTTCC->CGAGGGTTCCT
CGAGGGTTCCT->GAGGGTTCCTT
GAGGGTTCCTT->AGGGTTCCTTG
AGGGTTCCTTG->GGGTTCCTTGA
GGGTTCCTTGA->GGTTCCTTGAT
GGTTCCTTGAT->GTTCCTTGATG
GTTCCTTGATG->TTCCTTGATGG
TTCCTTGATGG->TCCTTGATGGA
TCCTTGATGGA->CCTTGATGGAC
CCTTGATGGAC->CTTGATGGACG
CTTGATGGACG->TTGATGGACGT
TTGATGGACGT->TGATGGACGTC
TGATGGACGTC->GATGGACGTCT
GATGGACGTCT->ATGGACGTCTA
ATGGACGTCTA->TGGACGTCTAT
TGGACGTCTAT->GGACGTCTATT
GGACGTCTATT->GACGTCTATTC
GACGTCTATTC->ACGTCTATTCT
ACGTCTATTCT->CGTCTATTCTG
CGTCTATTCTG->GTCTATTCTGA
GTCTATTCTGA->TCTATTCTGAA
TCTATTCTGAA->CTATTCTGAAG
CTATTCTGAAG->TATTCTGAAGG
TATTCTGAAGG->ATTCTGAAGGT
ATTCTGAAGGT->TTCTGAAGGTC
TTCTGAAGGTC->TCTGAAGGTCC
TCTGAAGGTCC->CTGAAGGTCCC
CTGAAGGTCCC->TGAAGGTCCCC
TGAAGGTCCCC->GAAGGTCCCCA
GAAGGTCCCCA->AAGGTCCCCAG
AAGGTCCCCAG->AGGTCCCCAGA
AGGTCCCCAGA->GGTCCCCAGAA
GGTCCCCAGAA->GTCCCCAGAAG
GTCCCCAGAAG->TCCCCAGAAGT
TCCCCAGAAGT->CCCCAGAAGTA
CCCCAGAAGTA->CCCAGAAGTAT
CCCAGAAGTAT->CCAGAAGTATG
CCAGAAGTATG->CAGAAGTATGT
CAGAAGTATGT->AGAAGTATGTC
AGAAGTATGTC->GAAGTATGTCT
GAAGTATGTCT->AAGTATGTCTC
AAGTATGTCTC->AGTATGTCTCA
AGTATGTCTCA->GTATGTCTCAC
GTATGTCTCAC->TATGTCTCACA
TATGTCTCACA->ATGTCTCACAT
ATGTCTCACAT->TGTCTCACATC
TGTCTCACATC->GTCTCACATCG
GTCTCACATCG->TCTCACATCGG
TCTCACATCGG->CTCACATCGGA
CTCACATCGGA->TCACATCGGAA
TCACATCGGAA->CACATCGGAAA
CACATCGGAAA->ACATCGGAAAA
ACATCGGAAAA->CATCGGAAAAC
CATCGGAAAAC->ATCGGAAAACC
ATCGGAAAACC->TCGGAAAACCA
TCGGAAAACCA->CGGAAAACCAA
CGGAAAACCAA->GGAAAACCAAC
GGAAAACCAAC->GAAAACCAACC
GAAAACCAACC->AAAACCAACCG
AAAACCAACCG->AAACCAACCGA
AAACCAACCGA->AACCAACCGAG
AACCAACCGAG->ACCAACCGAGC
ACCAACCGAGC->CCAACCGAGCG
CCAACCGAGCG->CAACCGAGCGT
CAACCGAGCGT->AACCGAGCGTC
AACCGAGCGTC->ACCGAGCGTCA
ACCGAGCGTCA->CCGAGCGTCAC
CCGAGCGTCAC->CGAGCGTCACA
CGAGCGTCACA->GAGCGTCACAG
GAGCGTCACAG->AGCGTCACAGA
AGCGTCACAGA->GCGTCACAGAT
GCGTCACAGAT->CGTCACAGATT
CGTCACAGATT->GTCACAGATTC
GTCACAGATTC->TCACAGATTCA
TCACAGATTCA->CACAGATTCAT
CACAGATTCAT->ACAGATTCATC
ACAGATTCATC->CAGATTCATCT
CAGATTCATCT->AGATTCATCTT
AGATTCATCTT->GATTCATCTTT
GATTCATCTTT->ATTCATCTTTT
ATTCATCTTTT->TTCATCTTTTG
TTCATCTTTTG->TCATCTTTTGC
TCATCTTTTGC->CATCTTTTGCT
CATCTTTTGCT->ATCTTTTGCTT
ATCTTTTGCTT->TCTTTTGCTTA
TCTTTTGCTTA->CTTTTGCTTAT
CTTTTGCTTAT->TTTTGCTTATC
TTTTGCTTATC->TTTGCTTATCC
TTTGCTTATCC->TTGCTTATCCC
TTGCTTATCCC->TGCTTATCCCA
TGCTTATCCCA->GCTTATCCCAG
GCTTATCCCAG->CTTATCCCAGT
CTTATCCCAGT->TTATCCCAGTG
TTATCCCAGTG->TATCCCAGTGA
TATCCCAGTGA->ATCCCAGTGAG
ATCCCAGTGAG->TCCCAGTGAGG
TCCCAGTGAGG->CCCAGTGAGGC
CCCAGTGAGGC->CCAGTGAGGCT
CCAGTGAGGCT->CAGTGAGGCTA
CAGTGAGGCTA->AGTGAGGCTAG
AGTGAGGCTAG->GTGAGGCTAGG
GTGAGGCTAGG->TGAGGCTAGGT
TGAGGCTAGGT->GAGGCTAGGTT
GAGGCTAGGTT->AGGCTAGGTTT
AGGCTAGGTTT->GGCTAGGTTTG
GGCTAGGTTTG->GCTAGGTTTGT
GCTAGGTTTGT->CTAGGTTTGTG
CTAGGTTTGTG->TAGGTTTGTGA
TAGGTTTGTGA->AGGTTTGTGAA
AGGTTTGTGAA->GGTTTGTGAAG
GGTTTGTGAAG->GTTTGTGAAGC
GTTTGTGAAGC->TTTGTGAAGCG
TTTGTGAAGCG->TTGTGAAGCGT
TTGTGAAGCGT->TGTGAAGCGTC
TGTGAAGCGTC->GTGAAGCGTCG
GTGAAGCGTCG->TGAAGCGTCGG
TGAAGCGTCGG->GAAGCGTCGGG
GAAGCGTCGGG->AAGCGTCGGGA
AAGCGTCGGGA->AGCGTCGGGAT
AGCGTCGGGAT->GCGTCGGGATT
GCGTCGGGATT->CGTCGGGATTG
CGTCGGGATTG->GTCGGGATTGG
GTCGGGATTGG->TCGGGATTGGT
TCGGGATTGGT->CGGGATTGGTG
CGGGATTGGTG->GGGATTGGTGT
GGGATTGGTGT->GGATTGGTGTG
GGATTGGTGTG->GATTGGTGTGG
GATTGGTGTGG->ATTGGTGTGGT
ATTGGTGTGGT->TTGGTGTGGTA
TTGGTGTGGTA->TGGTGTGGTAA
TGGTGTGGTAA->GGTGTGGTAAA
GGTGTGGTAAA->GTGTGGTAAAG
GTGTGGTAAAG->TGTGGTAAAGC
TGTGGTAAAGC->GTGGTAAAGCT
GTGGTAAAGCT->TGGTAAAGCTG
TGGTAAAGCTG->GGTAAAGCTGC
GGTAAAGCTGC->GTAAAGCTGCC
GTAAAGCTGCC->TAAAGCTGCCC
TAAAGCTGCCC->AAAGCTGCCCT
AAAGCTGCCCT->AAGCTGCCCTT
AAGCTGCCCTT->AGCTGCCCTTA
AGCTGCCCTTA->GCTGCCCTTAC
GCTGCCCTTAC->CTGCCCTTACT
CTGCCCTTACT->TGCCCTTACTC
TGCCCTTACTC->GCCCTTACTCA
GCCCTTACTCA->CCCTTACTCAC
CCCTTACTCAC->CCTTACTCACG
CCTTACTCACG->CTTACTCACGT
CTTACTCACGT->TTACTCACGTC
TTACTCACGTC->TACTCACGTCG
TACTCACGTCG->ACTCACGTCGT
ACTCACGTCGT->CTCACGTCGTT
CTCACGTCGTT->TCACGTCGTTG
TCACGTCGTTG->CACGTCGTTGC
CACGTCGTTGC->ACGTCGTTGCC
ACGTCGTTGCC->CGTCGTTGCCC
CGTCGTTGCCC->GTCGTTGCCCG
GTCGTTGCCCG->TCGTTGCCCGA
TCGTTGCCCGA->CGTTGCCCGAA
CGTTGCCCGAA->GTTGCCCGAAC
GTTGCCCGAAC->TTGCCCGAACA
TTGCCCGAACA->TGCCCGAACAA
TGCCCGAACAA->GCCCGAACAAT
GCCCGAACAAT->CCCGAACAATG
CCCGAACAATG->CCGAACAATGT
CCGAACAATGT->CGAACAATGTT
CGAACAATGTT->GAACAATGTTC
GAACAATGTTC->AACAATGTTCT
AACAATGTTCT->ACAATGTTCTC
ACAATGTTCTC->CAATGTTCTCG
CAATGTTCTCG->AATGTTCTCGT
AATGTTCTCGT->ATGTTCTCGTA
ATGTTCTCGTA->TGTTCTCGTAG
TGTTCTCGTAG->GTTCTCGTAGC
GTTCTCGTAGC->TTCTCGTAGCG
TTCTCGTAGCG->TCTCGTAGCGC
TCTCGTAGCGC->CTCGTAGCGCG
CTCGTAGCGCG->TCGTAGCGCGC
TCGTAGCGCGC->CGTAGCGCGCG
CGTAGCGCGCG->GTAGCGCGCGC
GTAGCGCGCGC->TAGCGCGCGCA
TAGCGCGCGCA->AGCGCGCGCAC
AGCGCGCGCAC->GCGCGCGCACT
GCGCGCGCACT->CGCGCGCACTG
CGCGCGCACTG->GCGCGCACTGA
GCGCGCACTGA->CGCGCACTGAT
CGCGCACTGAT->GCGCACTGATT
GCGCACTGATT->CGCACTGATTC
CGCACTGATTC->GCACTGATTCC
GCACTGATTCC->CACTGATTCCT
CACTGATTCCT->ACTGATTCCTT
ACTGATTCCTT->CTGATTCCTTA
CTGATTCCTTA->TGATTCCTTAG
TGATTCCTTAG->GATTCCTTAGC
GATTCCTTAGC->ATTCCTTAGCT
ATTCCTTAGCT->TTCCTTAGCTT
TTCCTTAGCTT->TCCTTAGCTTT
TCCTTAGCTTT->CCTTAGCTTTA
CCTTAGCTTTA->CTTAGCTTTAA
CTTAGCTTTAA->TTAGCTTTAAA
TTAGCTTTAAA->TAGCTTTAAAA
TAGCTTTAAAA->AGCTTTAAAAT
AGCTTTAAAAT->GCTTTAAAATC
GCTTTAAAATC->CTTTAAAATCG
CTTTAAAATCG->TTTAAAATCGC
TTTAAAATCGC->TTAAAATCGCT
TTAAAATCGCT->TAAAATCGCTG
TAAAATCGCTG->AAAATCGCTGG
AAAATCGCTGG->AAATCGCTGGA
AAATCGCTGGA->AATCGCTGGAC
AATCGCTGGAC->ATCGCTGGACG
ATCGCTGGACG->TCGCTGGACGT
TCGCTGGACGT->CGCTGGACGTC
CGCTGGACGTC->GCTGGACGTCC
GCTGGACGTCC->CTGGACGTCCG
CTGGACGTCCG->TGGACGTCCGA
TGGACGTCCGA->GGACGTCCGAT
GGACGTCCGAT->GACGTCCGATT
GACGTCCGATT->ACGTCCGATTG
ACGTCCGATTG->CGTCCGATTGC
CGTCCGATTGC->GTCCGATTGCG
GTCCGATTGCG->TCCGATTGCGT
TCCGATTGCGT->CCGATTGCGTT
CCGATTGCGTT->CGATTGCGTTC
CGATTGCGTTC->GATTGCGTTCT
GATTGCGTTCT->ATTGCGTTCTT
ATTGCGTTCTT->TTGCGTTCTTC
TTGCGTTCTTC->TGCGTTCTTCG
TGCGTTCTTCG->GCGTTCTTCGC
GCGTTCTTCGC->CGTTCTTCGCC
CGTTCTTCGCC->GTTCTTCGCCA
GTTCTTCGCCA->TTCTTCGCCAA
TTCTTCGCCAA->TCTTCGCCAAC
TCTTCGCCAAC->CTTCGCCAACG
CTTCGCCAACG->TTCGCCAACGC
TTCGCCAACGC->TCGCCAACGCC
TCGCCAACGCC->CGCCAACGCCC
CGCCAACGCCC->GCCAACGCCCG
GCCAACGCCCG->CCAACGCCCGG
CCAACGCCCGG->CAACGCCCGGT
CAACGCCCGGT->AACGCCCGGTT
AACGCCCGGTT->ACGCCCGGTTA
ACGCCCGGTTA->CGCCCGGTTAT
CGCCCGGTTAT->GCCCGGTTATA
GCCCGGTTATA->CCCGGTTATAT
CCCGGTTATAT->CCGGTTATATA
CCGGTTATATA->CGGTTATATAG
CGGTTATATAG->GGTTATATAGC
GGTTATATAGC->GTTATATAGCT
GTTATATAGCT->TTATATAGCTC
TTATATAGCTC->TATATAGCTCG
TATATAGCTCG->ATATAGCTCGT
ATATAGCTCGT->TATAGCTCGTG
TATAGCTCGTG->ATAGCTCGTGT
ATAGCTCGTGT->TAGCTCGTGTA
TAGCTCGTGTA->AGCTCGTGTAC
AGCTCGTGTAC->GCTCGTGTACG
GCTCGTGTACG->CTCGTGTACGC
CTCGTGTACGC->TCGTGTACGCT
TCGTGTACGCT->CGTGTACGCTC
CGTGTACGCTC->GTGTACGCTCT
GTGTACGCTCT->TGTACGCTCTA
TGTACGCTCTA->GTACGCTCTAA
GTACGCTCTAA->TACGCTCTAAG
TACGCTCTAAG->ACGCTCTAAGT
ACGCTCTAAGT->CGCTCTAAGTT
CGCTCTAAGTT->GCTCTAAGTTT
GCTCTAAGTTT->CTCTAAGTTTG
CTCTAAGTTTG->TCTAAGTTTGC
TCTAAGTTTGC->CTAAGTTTGCT
CTAAGTTTGCT->TAAGTTTGCTA
TAAGTTTGCTA->AAGTTTGCTAA
AAGTTTGCTAA->AGTTTGCTAAG
AGTTTGCTAAG->GTTTGCTAAGC
GTTTGCTAAGC->TTTGCTAAGCC
TTTGCTAAGCC->TTGCTAAGCCA
TTGCTAAGCCA->TGCTAAGCCAC
TGCTAAGCCAC->GCTAAGCCACA
GCTAAGCCACA->CTAAGCCACAT
CTAAGCCACAT->TAAGCCACATA
TAAGCCACATA->AAGCCACATAC
AAGCCACATAC->AGCCACATACA
AGCCACATACA->GCCACATACAT
GCCACATACAT->CCACATACATA
CCACATACATA->CACATACATAC
CACATACATAC->ACATACATACT
ACATACATACT->CATACATACTA
CATACATACTA->ATACATACTAC
ATACATACTAC->TACATACTACG
TACATACTACG->ACATACTACGC
ACATACTACGC->CATACTACGCA
CATACTACGCA->ATACTACGCAA
ATACTACGCAA->TACTACGCAAA
TACTACGCAAA->ACTACGCAAAG
ACTACGCAAAG->CTACGCAAAGC
CTACGCAAAGC->TACGCAAAGCG
TACGCAAAGCG->ACGCAAAGCGA
ACGCAAAGCGA->CGCAAAGCGAC
CGCAAAGCGAC->GCAAAGCGACC
GCAAAGCGACC->CAAAGCGACCA
CAAAGCGACCA->AAAGCGACCAT
AAAGCGACCAT->AAGCGACCATG
AAGCGACCATG->AGCGACCATGG
AGCGACCATGG->GCGACCATGGA
GCGACCATGGA->CGACCATGGAA
CGACCATGGAA->GACCATGGAAG
GACCATGGAAG->ACCATGGAAGT
ACCATGGAAGT->CCATGGAAGTG
CCATGGAAGTG->CATGGAAGTGG
CATGGAAGTGG->ATGGAAGTGGG
ATGGAAGTGGG->TGGAAGTGGGC
TGGAAGTGGGC->GGAAGTGGGCA
GGAAGTGGGCA->GAAGTGGGCAT
GAAGTGGGCAT->AAGTGGGCATG
AAGTGGGCATG->AGTGGGCATGT
AGTGGGCATGT->GTGGGCATGTT
GTGGGCATGTT->TGGGCATGTTG
TGGGCATGTTG->GGGCATGTTGT
GGGCATGTTGT->GGCATGTTGTG
GGCATGTTGTG->GCATGTTGTGT
GCATGTTGTGT->CATGTTGTGTG
CATGTTGTGTG->ATGTTGTGTGG
ATGTTGTGTGG->TGTTGTGTGGA
TGTTGTGTGGA->GTTGTGTGGAT
GTTGTGTGGAT->TTGTGTGGATA
TTGTGTGGATA->TGTGTGGATAT
TGTGTGGATAT->GTGTGGATATA
GTGTGGATATA->TGTGGATATAT
TGTGGATATAT->GTGGATATATG
GTGGATATATG->TGGATATATGT
TGGATATATGT->GGATATATGTG
GGATATATGTG->GATATATGTGC
GATATATGTGC->ATATATGTGCA
ATATATGTGCA->TATATGTGCAC
TATATGTGCAC->ATATGTGCACT
ATATGTGCACT->TATGTGCACTT
TATGTGCACTT->ATGTGCACTTT
ATGTGCACTTT->TGTGCACTTTC
TGTGCACTTTC->GTGCACTTTCA
GTGCACTTTCA->TGCACTTTCAC
TGCACTTTCAC->GCACTTTCACA
GCACTTTCACA->CACTTTCACAA
CACTTTCACAA->ACTTTCACAAC
ACTTTCACAAC->CTTTCACAACT
CTTTCACAACT->TTTCACAACTA
TTTCACAACTA->TTCACAACTAC
TTCACAACTAC->TCACAACTACC
TCACAACTACC->CACAACTACCG
CACAACTACCG->ACAACTACCGG
ACAACTACCGG->CAACTACCGGT
CAACTACCGGT->AACTACCGGTA
AACTACCGGTA->ACTACCGGTAG
ACTACCGGTAG->CTACCGGTAGA
CTACCGGTAGA->TACCGGTAGAT
TACCGGTAGAT->ACCGGTAGATC
ACCGGTAGATC->CCGGTAGATCA
CCGGTAGATCA->CGGTAGATCAG
CGGTAGATCAG->GGTAGATCAGA
GGTAGATCAGA->GTAGATCAGAA
GTAGATCAGAA->TAGATCAGAAG
TAGATCAGAAG->AGATCAGAAGG
AGATCAGAAGG->GATCAGAAGGG
GATCAGAAGGG->ATCAGAAGGGC
ATCAGAAGGGC->TCAGAAGGGCT
TCAGAAGGGCT->CAGAAGGGCTC
CAGAAGGGCTC->AGAAGGGCTCG
AGAAGGGCTCG->GAAGGGCTCGG
GAAGGGCTCGG->AAGGGCTCGGA
AAGGGCTCGGA->AGGGCTCGGAG
AGGGCTCGGAG->GGGCTCGGAGT
GGGCTCGGAGT->GGCTCGGAGTT
GGCTCGGAGTT->GCTCGGAGTTT
GCTCGGAGTTT->CTCGGAGTTTG
CTCGGAGTTTG->TCGGAGTTTGC
TCGGAGTTTGC->CGGAGTTTGCG
CGGAGTTTGCG->GGAGTTTGCGA
GGAGTTTGCGA->GAGTTTGCGAA
GAGTTTGCGAA->AGTTTGCGAAC
AGTTTGCGAAC->GTTTGCGAACA
GTTTGCGAACA->TTTGCGAACAC
TTTGCGAACAC->TTGCGAACACA
TTGCGAACACA->TGCGAACACAG
TGCGAACACAG->GCGAACACAGG
GCGAACACAGG->CGAACACAGGC
CGAACACAGGC->GAACACAGGCG
GAACACAGGCG->AACACAGGCGA
AACACAGGCGA->ACACAGGCGAA
ACACAGGCGAA->CACAGGCGAAG
CACAGGCGAAG->ACAGGCGAAGT
ACAGGCGAAGT->CAGGCGAAGTT
CAGGCGAAGTT->AGGCGAAGTTC
AGGCGAAGTTC->GGCGAAGTTCA
GGCGAAGTTCA->GCGAAGTTCAT
GCGAAGTTCAT->CGAAGTTCATT
CGAAGTTCATT->GAAGTTCATTG
GAAGTTCATTG->AAGTTCATTGC
AAGTTCATTGC->AGTTCATTGCA
AGTTCATTGCA->GTTCATTGCAG
GTTCATTGCAG->TTCATTGCAGT
TTCATTGCAGT->TCATTGCAGTG
TCATTGCAGTG->CATTGCAGTGG
CATTGCAGTGG->ATTGCAGTGGT
ATTGCAGTGGT->TTGCAGTGGTG
TTGCAGTGGTG->TGCAGTGGTGT
TGCAGTGGTGT->GCAGTGGTGTG
GCAGTGGTGTG->CAGTGGTGTGA
CAGTGGTGTGA->AGTGGTGTGAC
AGTGGTGTGAC->GTGGTGTGACT
GTGGTGTGACT->TGGTGTGACTT
TGGTGTGACTT->GGTGTGACTTG
GGTGTGACTTG->GTGTGACTTGT
GTGTGACTTGT->TGTGACTTGTT
TGTGACTTGTT->GTGACTTGTTG
GTGACTTGTTG->TGACTTGTTGG
TGACTTGTTGG->GACTTGTTGGT
GACTTGTTGGT->ACTTGTTGGTG
ACTTGTTGGTG->CTTGTTGGTGC
CTTGTTGGTGC->TTGTTGGTGCT
TTGTTGGTGCT->TGTTGGTGCTT
TGTTGGTGCTT->GTTGGTGCTTT
GTTGGTGCTTT->TTGGTGCTTTC
TTGGTGCTTTC->TGGTGCTTTCT
TGGTGCTTTCT->GGTGCTTTCTG
GGTGCTTTCTG->GTGCTTTCTGC
GTGCTTTCTGC->TGCTTTCTGCT
TGCTTTCTGCT->GCTTTCTGCTG
GCTTTCTGCTG->CTTTCTGCTGC
CTTTCTGCTGC->TTTCTGCTGCC
TTTCTGCTGCC->TTCTGCTGCCT
TTCTGCTGCCT->TCTGCTGCCTC
TCTGCTGCCTC->CTGCTGCCTCG
CTGCTGCCTCG->TGCTGCCTCGC
TGCTGCCTCGC->GCTGCCTCGCA
GCTGCCTCGCA->CTGCCTCGCAA
CTGCCTCGCAA->TGCCTCGCAAA
TGCCTCGCAAA->GCCTCGCAAAA
GCCTCGCAAAA->CCTCGCAAAAA
CCTCGCAAAAA->CTCGCAAAAAG
CTCGCAAAAAG->TCGCAAAAAGC
TCGCAAAAAGC->CGCAAAAAGCT
CGCAAAAAGCT->GCAAAAAGCTA
GCAAAAAGCTA->CAAAAAGCTAG
CAAAAAGCTAG->AAAAAGCTAGT
AAAAAGCTAGT->AAAAGCTAGTT
AAAAGCTAGTT->AAAGCTAGTTG
AAAGCTAGTTG->AAGCTAGTTGT
AAGCTAGTTGT->AGCTAGTTGTT
AGCTAGTTGTT->GCTAGTTGTTA
GCTAGTTGTTA->CTAGTTGTTAG
CTAGTTGTTAG->TAGTTGTTAGG
TAGTTGTTAGG->AGTTGTTAGGT
AGTTGTTAGGT->GTTGTTAGGTA
GTTGTTAGGTA->TTGTTAGGTAG
TTGTTAGGTAG->TGTTAGGTAGA
TGTTAGGTAGA->GTTAGGTAGAT
GTTAGGTAGAT->TTAGGTAGATG
TTAGGTAGATG->TAGGTAGATGG
TAGGTAGATGG->AGGTAGATGGT
AGGTAGATGGT->GGTAGATGGTG
GGTAGATGGTG->GTAGATGGTGC
GTAGATGGTGC->TAGATGGTGCA
TAGATGGTGCA->AGATGGTGCAA
AGATGGTGCAA->GATGGTGCAAA
GATGGTGCAAA->ATGGTGCAAAG
ATGGTGCAAAG->TGGTGCAAAGC
TGGTGCAAAGC->GGTGCAAAGCT
GGTGCAAAGCT->GTGCAAAGCTT
GTGCAAAGCTT->TGCAAAGCTTG
TGCAAAGCTTG->GCAAAGCTTGC
GCAAAGCTTGC->CAAAGCTTGCA
CAAAGCTTGCA->AAAGCTTGCAC
AAAGCTTGCAC->AAGCTTGCACC
AAGCTTGCACC->AGCTTGCACCT
AGCTTGCACCT->GCTTGCACCTC
GCTTGCACCTC->CTTGCACCTCA
CTTGCACCTCA->TTGCACCTCAC
TTGCACCTCAC->TGCACCTCACG,TGCACCTCACC
TGCACCTCACG->GCACCTCACGG
GCACCTCACGG->CACCTCACGGT
CACCTCACGGT->ACCTCACGGTT
ACCTCACGGTT->CCTCACGGTTT
CCTCACGGTTT->CTCACGGTTTT
CTCACGGTTTT->TCACGGTTTTT
TCACGGTTTTT->CACGGTTTTTG
CACGGTTTTTG->ACGGTTTTTGC
ACGGTTTTTGC->CGGTTTTTGCG
CGGTTTTTGCG->GGTTTTTGCGA
GGTTTTTGCGA->GTTTTTGCGAC
GTTTTTGCGAC->TTTTTGCGACT
TTTTTGCGACT->TTTTGCGACTT
TTTTGCGACTT->TTTGCGACTTC
TTTGCGACTTC->TTGCGACTTCA
TTGCGACTTCA->TGCGACTTCAG
TGCGACTTCAG->GCGACTTCAGT
GCGACTTCAGT->CGACTTCAGTT
CGACTTCAGTT->GACTTCAGTTC
GACTTCAGTTC->ACTTCAGTTCT
ACTTCAGTTCT->CTTCAGTTCTG
CTTCAGTTCTG->TTCAGTTCTGG
TTCAGTTCTGG->TCAGTTCTGGC
TCAGTTCTGGC->CAGTTCTGGCT
CAGTTCTGGCT->AGTTCTGGCTT
AGTTCTGGCTT->GTTCTGGCTTA
GTTCTGGCTTA->TTCTGGCTTAA
TTCTGGCTTAA->TCTGGCTTAAC
TCTGGCTTAAC->CTGGCTTAACG
CTGGCTTAACG->TGGCTTAACGA
TGGCTTAACGA->GGCTTAACGAT
GGCTTAACGAT->GCTTAACGATG
GCTTAACGATG->CTTAACGATGT
CTTAACGATGT->TTAACGATGTC
TTAACGATGTC->TAACGATGTCT
TAACGATGTCT->AACGATGTCTT
AACGATGTCTT->ACGATGTCTTC
ACGATGTCTTC->CGATGTCTTCA
CGATGTCTTCA->GATGTCTTCAG
GATGTCTTCAG->ATGTCTTCAGG
ATGTCTTCAGG->TGTCTTCAGGC
TGTCTTCAGGC->GTCTTCAGGCA
GTCTTCAGGCA->TCTTCAGGCAC
TCTTCAGGCAC->CTTCAGGCACT
CTTCAGGCACT->TTCAGGCACTT
TTCAGGCACTT->TCAGGCACTTG
TCAGGCACTTG->CAGGCACTTGC
CAGGCACTTGC->AGGCACTTGCT
AGGCACTTGCT->GGCACTTGCTG
GGCACTTGCTG->GCACTTGCTGG
GCACTTGCTGG->CACTTGCTGGC
CACTTGCTGGC->ACTTGCTGGCA
ACTTGCTGGCA->CTTGCTGGCAA
CTTGCTGGCAA->TTGCTGGCAAA
TTGCTGGCAAA->TGCTGGCAAAG
TGCTGGCAAAG->GCTGGCAAAGA
GCTGGCAAAGA->CTGGCAAAGAT
CTGGCAAAGAT->TGGCAAAGATT
TGGCAAAGATT->GGCAAAGATTT
GGCAAAGATTT->GCAAAGATTTA
GCAAAGATTTA->CAAAGATTTAG
CAAAGATTTAG->AAAGATTTAGA
AAAGATTTAGA->AAGATTTAGAT
AAGATTTAGAT->AGATTTAGATA
AGATTTAGATA->GATTTAGATAA
GATTTAGATAA->ATTTAGATAAC
ATTTAGATAAC->TTTAGATAACG
TTTAGATAACG->TTAGATAACGA
TTAGATAACGA->TAGATAACGAA
TAGATAACGAA->AGATAACGAAG
AGATAACGAAG->GATAACGAAGA
GATAACGAAGA->ATAACGAAGAA
ATAACGAAGAA->TAACGAAGAAG
TAACGAAGAAG->AACGAAGAAGT
AACGAAGAAGT->ACGAAGAAGTA
ACGAAGAAGTA->CGAAGAAGTAC
CGAAGAAGTAC->GAAGAAGTACT
GAAGAAGTACT->AAGAAGTACTC
AAGAAGTACTC->AGAAGTACTCT
AGAAGTACTCT->GAAGTACTCTT
GAAGTACTCTT->AAGTACTCTTA
AAGTACTCTTA->AGTACTCTTAA
AGTACTCTTAA->GTACTCTTAAC
GTACTCTTAAC->TACTCTTAACA
TACTCTTAACA->ACTCTTAACAG
ACTCTTAACAG->CTCTTAACAGA
CTCTTAACAGA->TCTTAACAGAT
TCTTAACAGAT->CTTAACAGATG
CTTAACAGATG->TTAACAGATGC
TTAACAGATGC->TAACAGATGCA
TAACAGATGCA->AACAGATGCAG
AACAGATGCAG->ACAGATGCAGT
ACAGATGCAGT->CAGATGCAGTT
CAGATGCAGTT->AGATGCAGTTT
AGATGCAGTTT->GATGCAGTTTA
GATGCAGTTTA->ATGCAGTTTAT
ATGCAGTTTAT->TGCAGTTTATA
TGCAGTTTATA->GCAGTTTATAG
GCAGTTTATAG->CAGTTTATAGA
CAGTTTATAGA->AGTTTATAGAC
AGTTTATAGAC->GTTTATAGACG
GTTTATAGACG->TTTATAGACGA
TTTATAGACGA->TTATAGACGAC
TTATAGACGAC->TATAGACGACA
TATAGACGACA->ATAGACGACAA
ATAGACGACAA->TAGACGACAAC
TAGACGACAAC->AGACGACAACG
AGACGACAACG->GACGACAACGG
GACGACAACGG->ACGACAACGGC
ACGACAACGGC->CGACAACGGCA
CGACAACGGCA->GACAACGGCAT
GACAACGGCAT->ACAACGGCATT
ACAACGGCATT->CAACGGCATTC
CAACGGCATTC->AACGGCATTCG
AACGGCATTCG->ACGGCATTCGG
ACGGCATTCGG->CGGCATTCGGG
CGGCATTCGGG->GGCATTCGGGG
GGCATTCGGGG->GCATTCGGGGG
GCATTCGGGGG->CATTCGGGGGA
CATTCGGGGGA->ATTCGGGGGAT
ATTCGGGGGAT->TTCGGGGGATT
TTCGGGGGATT->TCGGGGGATTA
TCGGGGGATTA->CGGGGGATTAA
CGGGGGATTAA->GGGGGATTAAA
GGGGGATTAAA->GGGGATTAAAA
GGGGATTAAAA->GGGATTAAAAG
GGGATTAAAAG->GGATTAAAAGT
GGATTAAAAGT->GATTAAAAGTT
GATTAAAAGTT->ATTAAAAGTTC
ATTAAAAGTTC->TTAAAAGTTCG
TTAAAAGTTCG->TAAAAGTTCGT
TAAAAGTTCGT->AAAAGTTCGTC
AAAAGTTCGTC->AAAGTTCGTCA
AAAGTTCGTCA->AAGTTCGTCAC
AAGTTCGTCAC->AGTTCGTCACA
AGTTCGTCACA->GTTCGTCACAC
GTTCGTCACAC->TTCGTCACACT
TTCGTCACACT->TCGTCACACTC
TCGTCACACTC->CGTCACACTCT
CGTCACACTCT->GTCACACTCTG
GTCACACTCTG->TCACACTCTGA
TCACACTCTGA->CACACTCTGAG
CACACTCTGAG->ACACTCTGAGA
ACACTCTGAGA->CACTCTGAGAT
CACTCTGAGAT->ACTCTGAGATT
ACTCTGAGATT->CTCTGAGATTA
CTCTGAGATTA->TCTGAGATTAT
TCTGAGATTAT->CTGAGATTATT
CTGAGATTATT->TGAGATTATTC
TGAGATTATTC->GAGATTATTCT
GAGATTATTCT->AGATTATTCTT
AGATTATTCTT->GATTATTCTTA
GATTATTCTTA->ATTATTCTTAG
ATTATTCTTAG->TTATTCTTAGT
TTATTCTTAGT->TATTCTTAGTC
TATTCTTAGTC->ATTCTTAGTCC
ATTCTTAGTCC->TTCTTAGTCCT
TTCTTAGTCCT->TCTTAGTCCTA
TCTTAGTCCTA->CTTAGTCCTAG
CTTAGTCCTAG->TTAGTCCTAGA
TTAGTCCTAGA->TAGTCCTAGAT
TAGTCCTAGAT->AGTCCTAGATA
AGTCCTAGATA->GTCCTAGATAT
GTCCTAGATAT->TCCTAGATATA
TCCTAGATATA->CCTAGATATAG
CCTAGATATAG->CTAGATATAGC
CTAGATATAGC->TAGATATAGCT
TAGATATAGCT->AGATATAGCTT
AGATATAGCTT->GATATAGCTTT
GATATAGCTTT->ATATAGCTTTC
ATATAGCTTTC->TATAGCTTTCA
TATAGCTTTCA->ATAGCTTTCAT
ATAGCTTTCAT->TAGCTTTCATC
TAGCTTTCATC->AGCTTTCATCT
AGCTTTCATCT->GCTTTCATCTT
GCTTTCATCTT->CTTTCATCTTG
CTTTCATCTTG->TTTCATCTTGG
TTTCATCTTGG->TTCATCTTGGC
TTCATCTTGGC->TCATCTTGGCC
TCATCTTGGCC->CATCTTGGCCC
CATCTTGGCCC->ATCTTGGCCCT
ATCTTGGCCCT->TCTTGGCCCTT
TCTTGGCCCTT->CTTGGCCCTTG
CTTGGCCCTTG->TTGGCCCTTGT
TTGGCCCTTGT->TGGCCCTTGTA
TGGCCCTTGTA->GGCCCTTGTAG
GGCCCTTGTAG->GCCCTTGTAGT
GCCCTTGTAGT->CCCTTGTAGTG
CCCTTGTAGTG->CCTTGTAGTGC
CCTTGTAGTGC->CTTGTAGTGCC
CTTGTAGTGCC->TTGTAGTGCCC
TTGTAGTGCCC->TGTAGTGCCCA
TGTAGTGCCCA->GTAGTGCCCAC
GTAGTGCCCAC->TAGTGCCCACG
TAGTGCCCACG->AGTGCCCACGA
AGTGCCCACGA->GTGCCCACGAG
GTGCCCACGAG->TGCCCACGAGA
TGCCCACGAGA->GCCCACGAGAT
GCCCACGAGAT->CCCACGAGATA
CCCACGAGATA->CCACGAGATAG
CCACGAGATAG->CACGAGATAGG
CACGAGATAGG->ACGAGATAGGC
ACGAGATAGGC->CGAGATAGGCG
CGAGATAGGCG->GAGATAGGCGG
GAGATAGGCGG->AGATAGGCGGA
AGATAGGCGGA->GATAGGCGGAA
GATAGGCGGAA->ATAGGCGGAAT
ATAGGCGGAAT->TAGGCGGAATC
TAGGCGGAATC->AGGCGGAATCC
AGGCGGAATCC->GGCGGAATCCT
GGCGGAATCCT->GCGGAATCCTC
GCGGAATCCTC->CGGAATCCTCG
CGGAATCCTCG->GGAATCCTCGG
GGAATCCTCGG->GAATCCTCGGA
GAATCCTCGGA->AATCCTCGGAG
AATCCTCGGAG->ATCCTCGGAGC
ATCCTCGGAGC->TCCTCGGAGCC
TCCTCGGAGCC->CCTCGGAGCCG
CCTCGGAGCCG->CTCGGAGCCGC
CTCGGAGCCGC->TCGGAGCCGCA
TCGGAGCCGCA->CGGAGCCGCAG
CGGAGCCGCAG->GGAGCCGCAGT
GGAGCCGCAGT->GAGCCGCAGTG
GAGCCGCAGTG->AGCCGCAGTGA
AGCCGCAGTGA->GCCGCAGTGAG
GCCGCAGTGAG->CCGCAGTGAGC
CCGCAGTGAGC->CGCAGTGAGCC
CGCAGTGAGCC->GCAGTGAGCCG
GCAGTGAGCCG->CAGTGAGCCGG
CAGTGAGCCGG->AGTGAGCCGGC
AGTGAGCCGGC->GTGAGCCGGCA
GTGAGCCGGCA->TGAGCCGGCAA
TGAGCCGGCAA->GAGCCGGCAAT
GAGCCGGCAAT->AGCCGGCAATA
AGCCGGCAATA->GCCGGCAATAC
GCCGGCAATAC->CCGGCAATACC
CCGGCAATACC->CGGCAATACCT
CGGCAATACCT->GGCAATACCTA
GGCAATACCTA->GCAATACCTAG
GCAATACCTAG->CAATACCTAGA
CAATACCTAGA->AATACCTAGAT
AATACCTAGAT->ATACCTAGATG
ATACCTAGATG->TACCTAGATGA
TACCTAGATGA->ACCTAGATGAC
ACCTAGATGAC->CCTAGATGACA
CCTAGATGACA->CTAGATGACAT
CTAGATGACAT->TAGATGACATA
TAGATGACATA->AGATGACATAT
AGATGACATAT->GATGACATATG
GATGACATATG->ATGACATATGT
ATGACATATGT->TGACATATGTG
TGACATATGTG->GACATATGTGA
GACATATGTGA->ACATATGTGAT
ACATATGTGAT->CATATGTGATG
CATATGTGATG->ATATGTGATGC
ATATGTGATGC->TATGTGATGCA
TATGTGATGCA->ATGTGATGCAG
ATGTGATGCAG->TGTGATGCAGA
TGTGATGCAGA->GTGATGCAGAG
GTGATGCAGAG->TGATGCAGAGG
TGATGCAGAGG->GATGCAGAGGT
GATGCAGAGGT->ATGCAGAGGTC
ATGCAGAGGTC->TGCAGAGGTCA
TGCAGAGGTCA->GCAGAGGTCAG
GCAGAGGTCAG->CAGAGGTCAGC
CAGAGGTCAGC->AGAGGTCAGCG
AGAGGTCAGCG->GAGGTCAGCGC
GAGGTCAGCGC->AGGTCAGCGCT
AGGTCAGCGCT->GGTCAGCGCTC
GGTCAGCGCTC->GTCAGCGCTCA
GTCAGCGCTCA->TCAGCGCTCAC
TCAGCGCTCAC->CAGCGCTCACC
CAGCGCTCACC->AGCGCTCACCA
AGCGCTCACCA->GCGCTCACCAT
GCGCTCACCAT->CGCTCACCATT
CGCTCACCATT->GCTCACCATTT
GCTCACCATTT->CTCACCATTTA
CTCACCATTTA->TCACCATTTAG
TCACCATTTAG->CACCATTTAGC
CACCATTTAGC->ACCATTTAGCG
ACCATTTAGCG->CCATTTAGCGG
CCATTTAGCGG->CATTTAGCGGT
CATTTAGCGGT->ATTTAGCGGTC
ATTTAGCGGTC->TTTAGCGGTCG
TTTAGCGGTCG->TTAGCGGTCGC
TTAGCGGTCGC->TAGCGGTCGCC
TAGCGGTCGCC->AGCGGTCGCCA
AGCGGTCGCCA->GCGGTCGCCAT
GCGGTCGCCAT->CGGTCGCCATA
CGGTCGCCATA->GGTCGCCATAA
GGTCGCCATAA->GTCGCCATAAG
GTCGCCATAAG->TCGCCATAAGT
TCGCCATAAGT->CGCCATAAGTT
CGCCATAAGTT->GCCATAAGTTG
GCCATAAGTTG->CCATAAGTTGC
CCATAAGTTGC->CATAAGTTGCA
CATAAGTTGCA->ATAAGTTGCAC
ATAAGTTGCAC->TAAGTTGCACC
TAAGTTGCACC->AAGTTGCACCT
AAGTTGCACCT->AGTTGCACCTC
AGTTGCACCTC->GTTGCACCTCA
GTTGCACCTCA->TTGCACCTCAC
TGCACCTCACC->GCACCTCACCA
GCACCTCACCA->CACCTCACCAT
CACCTCACCAT->ACCTCACCATC
ACCTCACCATC->CCTCACCATCC
CCTCACCATCC->CTCACCATCCG
CTCACCATCCG->TCACCATCCGG
TCACCATCCGG->CACCATCCGGC
CACCATCCGGC->ACCATCCGGCC
ACCATCCGGCC->CCATCCGGCCC
CCATCCGGCCC->CATCCGGCCCC
CATCCGGCCCC->ATCCGGCCCCT
ATCCGGCCCCT->TCCGGCCCCTC
TCCGGCCCCTC->CCGGCCCCTCT
CCGGCCCCTCT->CGGCCCCTCTG
CGGCCCCTCTG->GGCCCCTCTGT
GGCCCCTCTGT->GCCCCTCTGTT
GCCCCTCTGTT->CCCCTCTGTTA
CCCCTCTGTTA->CCCTCTGTTAT
CCCTCTGTTAT->CCTCTGTTATC
CCTCTGTTATC->CTCTGTTATCT
CTCTGTTATCT->TCTGTTATCTC
TCTGTTATCTC->CTGTTATCTCG
CTGTTATCTCG->TGTTATCTCGC
TGTTATCTCGC->GTTATCTCGCT
GTTATCTCGCT->TTATCTCGCTT
TTATCTCGCTT->TATCTCGCTTG
TATCTCGCTTG->ATCTCGCTTGA
ATCTCGCTTGA->TCTCGCTTGAG
TCTCGCTTGAG->CTCGCTTGAGG
CTCGCTTGAGG->TCGCTTGAGGT
TCGCTTGAGGT->CGCTTGAGGTG
CGCTTGAGGTG->GCTTGAGGTGT
GCTTGAGGTGT->CTTGAGGTGTA
CTTGAGGTGTA->TTGAGGTGTAT
TTGAGGTGTAT->TGAGGTGTATG
TGAGGTGTATG->GAGGTGTATGG
GAGGTGTATGG->AGGTGTATGGG
AGGTGTATGGG->GGTGTATGGGC
GGTGTATGGGC->GTGTATGGGCT
GTGTATGGGCT->TGTATGGGCTG
TGTATGGGCTG->GTATGGGCTGG
GTATGGGCTGG->TATGGGCTGGA
TATGGGCTGGA->ATGGGCTGGAC
ATGGGCTGGAC->TGGGCTGGACA
TGGGCTGGACA->GGGCTGGACAG
GGGCTGGACAG->GGCTGGACAGA
GGCTGGACAGA->GCTGGACAGAC
GCTGGACAGAC->CTGGACAGACC
CTGGACAGACC->TGGACAGACCG
TGGACAGACCG->GGACAGACCGC
GGACAGACCGC->GACAGACCGCG
GACAGACCGCG->ACAGACCGCGG
ACAGACCGCGG->CAGACCGCGGG
CAGACCGCGGG->AGACCGCGGGC
AGACCGCGGGC->GACCGCGGGCG
GACCGCGGGCG->ACCGCGGGCGG
ACCGCGGGCGG->CCGCGGGCGGT
CCGCGGGCGGT->CGCGGGCGGTC
CGCGGGCGGTC->GCGGGCGGTCC
GCGGGCGGTCC->CGGGCGGTCCC
CGGGCGGTCCC->GGGCGGTCCCT
GGGCGGTCCCT->GGCGGTCCCTC
GGCGGTCCCTC->GCGGTCCCTCG
GCGGTCCCTCG->CGGTCCCTCGG
CGGTCCCTCGG->GGTCCCTCGGC
GGTCCCTCGGC->GTCCCTCGGCT
GTCCCTCGGCT->TCCCTCGGCTT
TCCCTCGGCTT->CCCTCGGCTTC
CCCTCGGCTTC->CCTCGGCTTCA
CCTCGGCTTCA->CTCGGCTTCAT
CTCGGCTTCAT->TCGGCTTCATT
TCGGCTTCATT->CGGCTTCATTG
CGGCTTCATTG->GGCTTCATTGG
GGCTTCATTGG->GCTTCATTGGT
GCTTCATTGGT->CTTCATTGGTG
CTTCATTGGTG->TTCATTGGTGC
TTCATTGGTGC->TCATTGGTGCC
TCATTGGTGCC->CATTGGTGCCT
CATTGGTGCCT->ATTGGTGCCTA
ATTGGTGCCTA->TTGGTGCCTAG
TTGGTGCCTAG->TGGTGCCTAGC
TGGTGCCTAGC->GGTGCCTAGCC
GGTGCCTAGCC->GTGCCTAGCCG
GTGCCTAGCCG->TGCCTAGCCGT
TGCCTAGCCGT->GCCTAGCCGTC
GCCTAGCCGTC->CCTAGCCGTCG
CCTAGCCGTCG->CTAGCCGTCGG
CTAGCCGTCGG->TAGCCGTCGGA
TAGCCGTCGGA->AGCCGTCGGAT
AGCCGTCGGAT->GCCGTCGGATT
GCCGTCGGATT->CCGTCGGATTA
CCGTCGGATTA->CGTCGGATTAA
CGTCGGATTAA->GTCGGATTAAA
GTCGGATTAAA->TCGGATTAAAA
TCGGATTAAAA->CGGATTAAAAA
CGGATTAAAAA->GGATTAAAAAA
GGATTAAAAAA->GATTAAAAAAG
GATTAAAAAAG->ATTAAAAAAGT
ATTAAAAAAGT->TTAAAAAAGTT
TTAAAAAAGTT->TAAAAAAGTTA
TAAAAAAGTTA->AAAAAAGTTAG
AAAAAAGTTAG->AAAAAGTTAGC
AAAAAGTTAGC->AAAAGTTAGCA
AAAAGTTAGCA->AAAGTTAGCAC
AAAGTTAGCAC->AAGTTAGCACG
AAGTTAGCACG->AGTTAGCACGT
AGTTAGCACGT->GTTAGCACGTG
GTTAGCACGTG->TTAGCACGTGG
TTAGCACGTGG->TAGCACGTGGT
TAGCACGTGGT->AGCACGTGGTA
AGCACGTGGTA->GCACGTGGTAG
GCACGTGGTAG->CACGTGGTAGA
CACGTGGTAGA->ACGTGGTAGAG
ACGTGGTAGAG->CGTGGTAGAGT
CGTGGTAGAGT->GTGGTAGAGTG
GTGGTAGAGTG->TGGTAGAGTGA
TGGTAGAGTGA->GGTAGAGTGAT
GGTAGAGTGAT->GTAGAGTGATA
GTAGAGTGATA->TAGAGTGATAG
TAGAGTGATAG->AGAGTGATAGT
AGAGTGATAGT->GAGTGATAGTC
GAGTGATAGTC->AGTGATAGTCT
AGTGATAGTCT->GTGATAGTCTC
GTGATAGTCTC->TGATAGTCTCG
TGATAGTCTCG->GATAGTCTCGG
GATAGTCTCGG->ATAGTCTCGGT
ATAGTCTCGGT->TAGTCTCGGTA
TAGTCTCGGTA->AGTCTCGGTAT
AGTCTCGGTAT->GTCTCGGTATC
GTCTCGGTATC->TCTCGGTATCT
TCTCGGTATCT->CTCGGTATCTG
CTCGGTATCTG->TCGGTATCTGT
TCGGTATCTGT->CGGTATCTGTA
CGGTATCTGTA->GGTATCTGTAG
GGTATCTGTAG->GTATCTGTAGC
GTATCTGTAGC->TATCTGTAGCA
TATCTGTAGCA->ATCTGTAGCAA
ATCTGTAGCAA->TCTGTAGCAAA
TCTGTAGCAAA->CTGTAGCAAAC
CTGTAGCAAAC->TGTAGCAAACG
TGTAGCAAACG->GTAGCAAACGG
GTAGCAAACGG->TAGCAAACGGC
TAGCAAACGGC->AGCAAACGGCT
AGCAAACGGCT->GCAAACGGCTA
GCAAACGGCTA->CAAACGGCTAA
CAAACGGCTAA->AAACGGCTAAC
AAACGGCTAAC->AACGGCTAACG
AACGGCTAACG->ACGGCTAACGT
ACGGCTAACGT->CGGCTAACGTT
CGGCTAACGTT->GGCTAACGTTT
GGCTAACGTTT->GCTAACGTTTC
GCTAACGTTTC->CTAACGTTTCA
CTAACGTTTCA->TAACGTTTCAG
TAACGTTTCAG->AACGTTTCAGT
AACGTTTCAGT->ACGTTTCAGTT
ACGTTTCAGTT->CGTTTCAGTTA
CGTTTCAGTTA->GTTTCAGTTAC
GTTTCAGTTAC->TTTCAGTTACA
TTTCAGTTACA->TTCAGTTACAC
TTCAGTTACAC->TCAGTTACACC
TCAGTTACACC->CAGTTACACCG
CAGTTACACCG->AGTTACACCGC
AGTTACACCGC->GTTACACCGCT
GTTACACCGCT->TTACACCGCTG
TTACACCGCTG->TACACCGCTGA
TACACCGCTGA->ACACCGCTGAG
ACACCGCTGAG->CACCGCTGAGC
CACCGCTGAGC->ACCGCTGAGCG
ACCGCTGAGCG->CCGCTGAGCGG
CCGCTGAGCGG->CGCTGAGCGGC
CGCTGAGCGGC->GCTGAGCGGCG
GCTGAGCGGCG->CTGAGCGGCGA
